country,date,tests_cumulative,pcr_tests_cum,pcr_tests_new,rapid_test_cum,rapid_test_new,pcr_tests_cum_corrected,pcr_tests_new_corrected,rapid_test_cum_corrected,rapid_test_new_corrected
Austria,2021-03-22,20476485,6382399,6382399,14094086,14094086,6382399,6382399,14094086,14094086
Austria,2021-03-23,20846292,6431566,49167,14414726,320640,6431566,49167,14414726,320640
Austria,2021-03-24,21147134,6493316,61750,14653818,239092,6493316,61750,14653818,239092
Austria,2021-03-25,21565462,6568554,75238,14996908,343090,6568554,75238,14996908,343090
Austria,2021-03-26,22051094,6556772,-11782,15494322,497414,6556772,-11782,15494322,497414
Austria,2021-03-27,22194436,6333726,-223046,15860710,366388,6333726,-223046,15860710,366388
Austria,2021-03-28,22455472,6383732,50006,16071740,211030,6383732,50006,16071740,211030
Austria,2021-03-29,22610260,6421765,38033,16188495,116755,6421765,38033,16188495,116755
Austria,2021-03-30,23093306,6474269,52504,16619037,430542,6474269,52504,16619037,430542
Austria,2021-03-31,23451521,6543059,68790,16908462,289425,6543059,68790,16908462,289425
Austria,2021-04-01,23805240,6616140,73081,17189100,280638,6616140,73081,17189100,280638
Austria,2021-04-02,24086423,6685800,69660,17400623,211523,6685800,69660,17400623,211523
Austria,2021-04-03,24402915,6745518,59718,17657397,256774,6745518,59718,17657397,256774
Austria,2021-04-04,24647471,6800940,55422,17846531,189134,6800940,55422,17846531,189134
Austria,2021-04-05,24779805,6840428,39488,17939377,92846,6840428,39488,17939377,92846
Austria,2021-04-06,24999349,6867638,27210,18131711,192334,6867638,27210,18131711,192334
Austria,2021-04-07,25515997,6936131,68493,18579866,448155,6936131,68493,18579866,448155
Austria,2021-04-08,25868498,7003627,67496,18864871,285005,7003627,67496,18864871,285005
Austria,2021-04-09,26161838,7080109,76482,19081729,216858,7080109,76482,19081729,216858
Austria,2021-04-10,26478234,7151199,71090,19327035,245306,7151199,71090,19327035,245306
Austria,2021-04-11,26679075,7193982,42783,19485093,158058,7193982,42783,19485093,158058
Austria,2021-04-12,26848583,7232009,38027,19616574,131481,7232009,38027,19616574,131481
Austria,2021-04-13,27197861,7300539,68530,19897322,280748,7300539,68530,19897322,280748
Austria,2021-04-14,27703138,7374937,74398,20328201,430879,7374937,74398,20328201,430879
Austria,2021-04-15,28012081,7446224,71287,20565857,237656,7446224,71287,20565857,237656
Austria,2021-04-16,28298620,7530102,83878,20768518,202661,7530102,83878,20768518,202661
Austria,2021-04-18,28823897,7650883,120781,21173014,404496,7650883,120781,21173014,404496
Austria,2021-04-19,29014550,7687817,36934,21326733,153719,7687817,36934,21326733,153719
Austria,2021-04-20,29335166,7748621,60804,21586545,259812,7748621,60804,21586545,259812
Austria,2021-04-21,29597609,7832919,84298,21764690,178145,7832919,84298,21764690,178145
Austria,2021-04-22,29905570,7905428,72509,22000142,235452,7905428,72509,22000142,235452
Austria,2021-04-23,30186461,7988411,82983,22198050,197908,7988411,82983,22198050,197908
Austria,2021-04-24,30489054,8055172,66761,22433882,235832,8055172,66761,22433882,235832
Austria,2021-04-25,30688612,8117301,62129,22517311,83429,8117301,62129,22517311,83429
Austria,2021-04-26,30836351,8151042,33741,22685309,167998,8151042,33741,22685309,167998
Austria,2021-04-27,31263052,8216127,65085,23046925,361616,8216127,65085,23046925,361616
Austria,2021-04-28,31317709,8306460,90333,23011249,-35676,8306460,90333,23011249,-35676
Austria,2021-04-29,31589724,8361368,54908,23228356,217107,8361368,54908,23228356,217107
Austria,2021-04-30,31892904,8470217,108849,23422687,194331,8470217,108849,23422687,194331
Austria,2021-05-01,32228406,8537299,67082,23691107,268420,8537299,67082,23691107,268420
Austria,2021-05-02,32383974,8577920,40621,23806054,114947,8577920,40621,23806054,114947
Austria,2021-05-03,32495877,8595272,17352,23900605,94551,8595272,17352,23900605,94551
Austria,2021-05-04,32895293,8680800,85528,24214493,313888,8680800,85528,24214493,313888
Austria,2021-05-05,33241683,8777488,96688,24464195,249702,8777488,96688,24464195,249702
Austria,2021-05-06,33702259,8863055,85567,24839204,375009,8863055,85567,24839204,375009
Austria,2021-05-07,33990188,8948640,85585,25041548,202344,8948640,85585,25041548,202344
Austria,2021-05-08,34299962,9018757,70117,25281205,239657,9018757,70117,25281205,239657
Austria,2021-05-09,34504177,9078393,59636,25425784,144579,9078393,59636,25425784,144579
Austria,2021-05-10,34639633,9105572,27179,25534061,108277,9105572,27179,25534061,108277
Austria,2021-06-02,43048076,10855201,1749629,32192875,6658814,10855201,1749629,32192875,6658814
Austria,2021-06-03,43729103,10954992,99791,32774111,581236,10954992,99791,32774111,581236
Austria,2021-06-04,44110345,11013261,58269,33097084,322973,11013261,58269,33097084,322973
Austria,2021-06-05,44858994,11092325,79064,33766669,669585,11092325,79064,33766669,669585
Austria,2021-06-06,45278379,11157892,65567,34120487,353818,11157892,65567,34120487,353818
Austria,2021-06-07,45570994,11184673,26781,34386321,265834,11184673,26781,34386321,265834
Austria,2021-06-08,45983005,11275295,90622,34707710,321389,11275295,90622,34707710,321389
Austria,2021-06-09,46426166,11365285,89990,35060881,353171,11365285,89990,35060881,353171
Austria,2021-06-10,46942669,11446506,81221,35496163,435282,11446506,81221,35496163,435282
Austria,2021-06-11,47268180,11532421,85915,35735759,239596,11532421,85915,35735759,239596
Austria,2021-06-12,47725434,11567937,35516,36157497,421738,11567937,35516,36157497,421738
Austria,2021-06-13,48145979,11623324,55387,36522655,365158,11623324,55387,36522655,365158
Austria,2021-06-14,48458730,11649354,26030,36809376,286721,11649354,26030,36809376,286721
Austria,2021-06-15,48813163,11730381,81027,37082782,273406,11730381,81027,37082782,273406
Austria,2021-06-16,49167859,11808138,77757,37359721,276939,11808138,77757,37359721,276939
Austria,2021-06-17,49693906,11892572,84434,37801334,441613,11892572,84434,37801334,441613
Austria,2021-06-18,50183597,11970036,77464,38213561,412227,11970036,77464,38213561,412227
Austria,2021-06-19,50663929,12052003,81967,38611926,398365,12052003,81967,38611926,398365
Austria,2021-06-20,51082866,12101448,49445,38981418,369492,12101448,49445,38981418,369492
Austria,2021-06-21,51457883,12133217,31769,39324666,343248,12133217,31769,39324666,343248
Austria,2021-06-22,52163509,12171425,38208,39992084,667418,12171425,38208,39992084,667418
Austria,2021-06-23,52553372,12279104,107679,40274268,282184,12279104,107679,40274268,282184
Austria,2021-06-24,52844278,12347540,68436,40496738,222470,12347540,68436,40496738,222470
Austria,2021-06-25,53295938,12418059,70519,40877879,381141,12418059,70519,40877879,381141
Austria,2021-06-26,53713546,12484859,66800,41228687,350808,12484859,66800,41228687,350808
Austria,2021-06-27,54026448,12489110,4251,41537338,308651,12489110,4251,41537338,308651
Austria,2021-07-01,55451224,12757593,268483,42741807,1204469,12757593,268483,42741807,1204469
Austria,2021-07-02,55710614,12833709,76116,42972473,230666,12833709,76116,42972473,230666
Austria,2021-07-03,56054549,12916172,82463,43308711,336238,12916172,82463,43308711,336238
Austria,2021-07-04,56615814,12968125,51953,43647689,338978,12968125,51953,43647689,338978
Austria,2021-07-05,56937916,13008771,40646,43929145,281456,13008771,40646,43929145,281456
Austria,2021-07-06,57285297,13071600,62829,44213697,284552,13071600,62829,44213697,284552
Austria,2021-07-07,57621285,13137707,66107,44483578,269881,13137707,66107,44483578,269881
Austria,2021-07-08,58003807,13204419,66712,44799388,315810,13204419,66712,44799388,315810
Austria,2021-07-09,58318037,13267341,62922,45050696,251308,13267341,62922,45050696,251308
Benin,2021-03-22,556742,520466,520466,36276,36276,520466,520466,36276,36276
Benin,2021-03-23,556742,520466,0,36276,0,520466,0,36276,0
Benin,2021-03-24,556742,520466,0,36276,0,520466,0,36276,0
Benin,2021-03-25,584760,548484,28018,36276,0,548484,28018,36276,0
Benin,2021-03-26,584760,548484,0,36276,0,548484,0,36276,0
Benin,2021-03-27,584760,548484,0,36276,0,548484,0,36276,0
Benin,2021-03-28,584760,548484,0,36276,0,548484,0,36276,0
Benin,2021-03-29,584760,548484,0,36276,0,548484,0,36276,0
Benin,2021-03-30,584760,548484,0,36276,0,548484,0,36276,0
Benin,2021-03-31,584760,548484,0,36276,0,548484,0,36276,0
Benin,2021-04-01,584760,548484,0,36276,0,548484,0,36276,0
Benin,2021-04-02,584760,548484,0,36276,0,548484,0,36276,0
Benin,2021-04-03,584760,548484,0,36276,0,548484,0,36276,0
Benin,2021-04-04,584760,548484,0,36276,0,548484,0,36276,0
Benin,2021-04-05,584760,548484,0,36276,0,548484,0,36276,0
Benin,2021-04-06,584760,548484,0,36276,0,548484,0,36276,0
Benin,2021-04-07,584760,548484,0,36276,0,548484,0,36276,0
Benin,2021-04-08,584760,548484,0,36276,0,548484,0,36276,0
Benin,2021-04-09,584760,548484,0,36276,0,548484,0,36276,0
Benin,2021-04-10,584760,548484,0,36276,0,548484,0,36276,0
Benin,2021-04-11,584760,548484,0,36276,0,548484,0,36276,0
Benin,2021-04-12,584760,548484,0,36276,0,548484,0,36276,0
Benin,2021-04-13,584760,548484,0,36276,0,548484,0,36276,0
Benin,2021-04-14,611364,575088,26604,36276,0,575088,26604,36276,0
Benin,2021-04-15,611364,575088,0,36276,0,575088,0,36276,0
Benin,2021-04-16,611364,575088,0,36276,0,575088,0,36276,0
Benin,2021-04-17,611364,575088,0,36276,0,575088,0,36276,0
Benin,2021-04-18,611364,575088,0,36276,0,575088,0,36276,0
Benin,2021-04-19,611364,575088,0,36276,0,575088,0,36276,0
Benin,2021-04-20,618119,581843,6755,36276,0,581843,6755,36276,0
Benin,2021-04-21,618119,581843,0,36276,0,581843,0,36276,0
Benin,2021-04-22,618119,581843,0,36276,0,581843,0,36276,0
Benin,2021-04-23,618119,581843,0,36276,0,581843,0,36276,0
Benin,2021-04-24,618119,581843,0,36276,0,581843,0,36276,0
Benin,2021-04-25,618119,581843,0,36276,0,581843,0,36276,0
Benin,2021-04-26,618119,581843,0,36276,0,581843,0,36276,0
Benin,2021-04-27,618119,581843,0,36276,0,581843,0,36276,0
Benin,2021-04-28,626490,590214,8371,36276,0,590214,8371,36276,0
Benin,2021-04-29,626490,590214,0,36276,0,590214,0,36276,0
Benin,2021-04-30,626490,590214,0,36276,0,590214,0,36276,0
Benin,2021-05-01,626490,590214,0,36276,0,590214,0,36276,0
Benin,2021-05-02,626490,590214,0,36276,0,590214,0,36276,0
Benin,2021-05-03,631388,595112,4898,36276,0,595112,4898,36276,0
Benin,2021-05-04,631388,595112,0,36276,0,595112,0,36276,0
Benin,2021-05-05,631388,595112,0,36276,0,595112,0,36276,0
Benin,2021-05-06,631388,595112,0,36276,0,595112,0,36276,0
Benin,2021-05-08,631388,595112,0,36276,0,595112,0,36276,0
Benin,2021-05-09,631388,595112,0,36276,0,595112,0,36276,0
Benin,2021-05-10,631388,595112,0,36276,0,595112,0,36276,0
Benin,2021-05-11,631388,595112,0,36276,0,595112,0,36276,0
Benin,2021-05-12,631388,595112,0,36276,0,595112,0,36276,0
Benin,2021-05-13,631388,595112,0,36276,0,595112,0,36276,0
Benin,2021-05-14,631388,595112,0,36276,0,595112,0,36276,0
Benin,2021-05-15,631388,595112,0,36276,0,595112,0,36276,0
Benin,2021-05-16,631388,595112,0,36276,0,595112,0,36276,0
Benin,2021-05-17,631388,595112,0,36276,0,595112,0,36276,0
Benin,2021-05-18,640586,604310,9198,36276,0,604310,9198,36276,0
Benin,2021-05-19,640586,604310,0,36276,0,604310,0,36276,0
Benin,2021-05-20,640586,604310,0,36276,0,604310,0,36276,0
Benin,2021-05-21,640586,604310,0,36276,0,604310,0,36276,0
Benin,2021-05-22,640586,604310,0,36276,0,604310,0,36276,0
Benin,2021-05-24,640586,604310,0,36276,0,604310,0,36276,0
Benin,2021-05-25,640586,604310,0,36276,0,604310,0,36276,0
Benin,2021-05-26,640586,604310,0,36276,0,604310,0,36276,0
Benin,2021-05-27,640586,604310,0,36276,0,604310,0,36276,0
Benin,2021-05-28,640586,604310,0,36276,0,604310,0,36276,0
Benin,2021-05-29,640586,604310,0,36276,0,604310,0,36276,0
Benin,2021-05-30,640586,604310,0,36276,0,604310,0,36276,0
Benin,2021-05-31,640586,604310,0,36276,0,604310,0,36276,0
Benin,2021-06-01,640586,604310,0,36276,0,604310,0,36276,0
Benin,2021-06-03,640586,604310,0,36276,0,604310,0,36276,0
Benin,2021-06-04,640586,604310,0,36276,0,604310,0,36276,0
Benin,2021-06-05,640586,604310,0,36276,0,604310,0,36276,0
Benin,2021-06-06,640586,604310,0,36276,0,604310,0,36276,0
Benin,2021-06-07,640586,604310,0,36276,0,604310,0,36276,0
Benin,2021-06-08,640586,604310,0,36276,0,604310,0,36276,0
Benin,2021-06-09,8137,8109,-596201,28,-36248,8109,-596201,28,-36248
Benin,2021-06-10,8137,8109,0,28,0,8109,0,28,0
Benin,2021-06-11,8137,8109,0,28,0,8109,0,28,0
Benin,2021-06-12,8137,8109,0,28,0,8109,0,28,0
Benin,2021-06-13,8137,8109,0,28,0,8109,0,28,0
Benin,2021-06-14,8137,8109,0,28,0,8109,0,28,0
Benin,2021-06-15,8137,8109,0,28,0,8109,0,28,0
Benin,2021-06-16,8194,8140,31,54,26,8140,31,54,26
Benin,2021-06-17,8194,8140,0,54,0,8140,0,54,0
Benin,2021-06-18,8194,8140,0,54,0,8140,0,54,0
Benin,2021-06-19,8194,8140,0,54,0,8140,0,54,0
Benin,2021-06-20,8194,8140,0,54,0,8140,0,54,0
Brazil,2021-03-22,23561497,14725192,14725192,8836305,8836305,14725192,14725192,8836305,8836305
Brazil,2021-03-23,23561497,14725192,0,8836305,0,14725192,0,8836305,0
Brazil,2021-03-24,23561497,14725192,0,8836305,0,14725192,0,8836305,0
Brazil,2021-03-25,23561497,14725192,0,8836305,0,14725192,0,8836305,0
Brazil,2021-03-26,23561497,14725192,0,8836305,0,14725192,0,8836305,0
Brazil,2021-03-27,23561497,14725192,0,8836305,0,14725192,0,8836305,0
Brazil,2021-03-28,23561497,14725192,0,8836305,0,14725192,0,8836305,0
Brazil,2021-03-29,23561497,14725192,0,8836305,0,14725192,0,8836305,0
Brazil,2021-03-30,23561497,14725192,0,8836305,0,14725192,0,8836305,0
Brazil,2021-03-31,23561497,14725192,0,8836305,0,14725192,0,8836305,0
Brazil,2021-04-01,23561497,14725192,0,8836305,0,14725192,0,8836305,0
Brazil,2021-04-02,23561497,14725192,0,8836305,0,14725192,0,8836305,0
Brazil,2021-04-03,23561497,14725192,0,8836305,0,14725192,0,8836305,0
Brazil,2021-04-04,23561497,14725192,0,8836305,0,14725192,0,8836305,0
Brazil,2021-04-05,23561497,14725192,0,8836305,0,14725192,0,8836305,0
Brazil,2021-04-06,23561497,14725192,0,8836305,0,14725192,0,8836305,0
Brazil,2021-04-07,23561497,14725192,0,8836305,0,14725192,0,8836305,0
Brazil,2021-04-08,23561497,14725192,0,8836305,0,14725192,0,8836305,0
Brazil,2021-04-09,23561497,14725192,0,8836305,0,14725192,0,8836305,0
Brazil,2021-04-10,23561497,14725192,0,8836305,0,14725192,0,8836305,0
Brazil,2021-04-11,23561497,14725192,0,8836305,0,14725192,0,8836305,0
Brazil,2021-04-12,23561497,14725192,0,8836305,0,14725192,0,8836305,0
Brazil,2021-04-13,23561497,14725192,0,8836305,0,14725192,0,8836305,0
Chile,2021-07-05,17291336,16903951,16903951,387385,387385,16903951,16903951,387385,387385
Chile,2021-07-06,17328099,16937808,33857,390291,2906,16937808,33857,390291,2906
Chile,2021-07-07,17365100,16968852,31044,396248,5957,16968852,31044,396248,5957
Chile,2021-07-08,17434180,17032368,63516,401812,5564,17032368,63516,401812,5564
Chile,2021-07-09,17501660,17094290,61922,407370,5558,17094290,61922,407370,5558
Colombia,2021-06-04,17305168,11780035,11780035,5525133,5525133,11780035,11780035,5525133,5525133
Colombia,2021-06-08,17625675,11976902,196867,5648773,123640,11976902,196867,5648773,123640
Colombia,2021-06-11,17912045,12133538,156636,5778507,129734,12133538,156636,5778507,129734
Colombia,2021-06-13,18114673,12237799,104261,5876874,98367,12237799,104261,5876874,98367
Colombia,2021-06-16,18340111,12386306,148507,5953805,76931,12386306,148507,5953805,76931
Colombia,2021-06-17,18451017,12450266,63960,6000751,46946,12450266,63960,6000751,46946
Colombia,2021-06-22,18929047,12710986,260720,6218061,217310,12710986,260720,6218061,217310
Colombia,2021-06-23,19040100,12771176,60190,6268924,50863,12771176,60190,6268924,50863
Colombia,2021-06-24,19168055,12827165,55989,6340890,71966,12827165,55989,6340890,71966
Colombia,2021-06-27,19519944,13014457,187292,6505487,164597,13014457,187292,6505487,164597
Colombia,2021-06-29,19695665,13117346,102889,6578319,72832,13117346,102889,6578319,72832
Colombia,2021-06-30,19822624,13182990,65644,6639634,61315,13182990,65644,6639634,61315
Colombia,2021-07-02,20060182,13305465,122475,6754717,115083,13305465,122475,6754717,115083
Colombia,2021-07-04,20282143,13419109,113644,6863034,108317,13419109,113644,6863034,108317
Colombia,2021-07-05,20384649,13475059,55950,6909590,46556,13475059,55950,6909590,46556
Colombia,2021-07-06,20435119,13513159,38100,6921960,12370,13513159,38100,6921960,12370
Colombia,2021-07-09,20711929,13668071,154912,7043858,121898,13668071,154912,7043858,121898
Czechia,2021-03-22,10841492,6016203,6016203,4825289,4825289,6016203,6016203,4825289,4825289
Czechia,2021-03-23,11051757,6044574,28371,5007183,181894,6044574,28371,5007183,181894
Czechia,2021-03-24,11278655,6078749,34175,5199906,192723,6078749,34175,5199906,192723
Czechia,2021-03-25,11490915,6107066,28317,5383849,183943,6107066,28317,5383849,183943
Czechia,2021-03-26,11690302,6133994,26928,5556308,172459,6133994,26928,5556308,172459
Czechia,2021-03-27,11871542,6160732,26738,5710810,154502,6160732,26738,5710810,154502
Czechia,2021-03-28,11956620,6174672,13940,5781948,71138,6174672,13940,5781948,71138
Czechia,2021-03-29,12028967,6180990,6318,5847977,66029,6180990,6318,5847977,66029
Czechia,2021-03-30,12265185,6206832,25842,6058353,210376,6206832,25842,6058353,210376
Czechia,2021-03-31,12484279,6236023,29191,6248256,189903,6236023,29191,6248256,189903
Czechia,2021-04-01,12709934,6262757,26734,6447177,198921,6262757,26734,6447177,198921
Czechia,2021-04-02,12937735,6285770,23013,6651965,204788,6285770,23013,6651965,204788
Czechia,2021-04-03,13037523,6302518,16748,6735005,83040,6302518,16748,6735005,83040
Czechia,2021-04-04,13107402,6311277,8759,6796125,61120,6311277,8759,6796125,61120
Czechia,2021-04-05,13174904,6318498,7221,6856406,60281,6318498,7221,6856406,60281
Czechia,2021-04-06,13259417,6325799,7301,6933618,77212,6325799,7301,6933618,77212
Czechia,2021-04-07,13550478,6349943,24144,7200535,266917,6349943,24144,7200535,266917
Czechia,2021-04-08,13812844,6378244,28301,7434600,234065,6378244,28301,7434600,234065
Czechia,2021-04-09,14038491,6401348,23104,7637143,202543,6401348,23104,7637143,202543
Czechia,2021-04-10,14230215,6424699,23351,7805516,168373,6424699,23351,7805516,168373
Czechia,2021-04-11,14308617,6435645,10946,7872972,67456,6435645,10946,7872972,67456
Czechia,2021-04-12,14397254,6441602,5957,7955652,82680,6441602,5957,7955652,82680
Czechia,2021-04-13,14635011,6461987,20385,8173024,217372,6461987,20385,8173024,217372
Czechia,2021-04-14,14872167,6484439,22452,8387728,214704,6484439,22452,8387728,214704
Czechia,2021-04-15,15102106,6507078,22639,8595028,207300,6507078,22639,8595028,207300
Czechia,2021-04-16,15332422,6524970,17892,8807452,212424,6524970,17892,8807452,212424
Czechia,2021-04-17,15507408,6536326,11356,8971082,163630,6536326,11356,8971082,163630
Czechia,2021-04-18,15590376,6550930,14604,9039446,68364,6550930,14604,9039446,68364
Czechia,2021-04-19,15718197,6560921,9991,9157276,117830,6560921,9991,9157276,117830
Czechia,2021-04-20,15989327,6582247,21326,9407080,249804,6582247,21326,9407080,249804
Czechia,2021-04-21,16239529,6603560,21313,9635969,228889,6603560,21313,9635969,228889
Czechia,2021-04-22,16478838,6623342,19782,9855496,219527,6623342,19782,9855496,219527
Czechia,2021-04-23,16723255,6641189,17847,10082066,226570,6641189,17847,10082066,226570
Czechia,2021-04-24,16937639,6657605,16416,10280034,197968,6657605,16416,10280034,197968
Czechia,2021-04-25,17010127,6664975,7370,10345152,65118,6664975,7370,10345152,65118
Czechia,2021-04-26,17124014,6673505,8530,10450509,105357,6673505,8530,10450509,105357
Czechia,2021-04-27,17388713,6693098,19593,10695615,245106,6693098,19593,10695615,245106
Czechia,2021-04-28,17646552,6713836,20738,10932716,237101,6713836,20738,10932716,237101
Czechia,2021-04-29,17890535,6732826,18990,11157709,224993,6732826,18990,11157709,224993
Czechia,2021-04-30,18138011,6750983,18157,11387028,229319,6750983,18157,11387028,229319
Czechia,2021-05-01,18347631,6769875,18892,11577756,190728,6769875,18892,11577756,190728
Czechia,2021-05-02,18422238,6783015,13140,11639223,61467,6783015,13140,11639223,61467
Czechia,2021-05-03,18530196,6789558,6543,11740638,101415,6789558,6543,11740638,101415
Czechia,2021-05-04,18816612,6808647,19089,12007965,267327,6808647,19089,12007965,267327
Czechia,2021-05-05,19088160,6828436,19789,12259724,251759,6828436,19789,12259724,251759
Czechia,2021-05-06,19341919,6846083,17647,12495836,236112,6846083,17647,12495836,236112
Czechia,2021-05-07,19585985,6861420,15337,12724565,228729,6861420,15337,12724565,228729
Czechia,2021-05-08,19804403,6879474,18054,12924929,200364,6879474,18054,12924929,200364
Czechia,2021-05-09,19893984,6892091,12617,13001893,76964,6892091,12617,13001893,76964
Czechia,2021-05-10,19988974,6898801,6710,13090173,88280,6898801,6710,13090173,88280
Czechia,2021-05-11,20283907,6919695,20894,13364212,274039,6919695,20894,13364212,274039
Czechia,2021-05-12,20529829,6937202,17507,13592627,228415,6937202,17507,13592627,228415
Czechia,2021-05-13,20767772,6952575,15373,13815197,222570,6952575,15373,13815197,222570
Czechia,2021-05-14,21004062,6966723,14148,14037339,222142,6966723,14148,14037339,222142
Czechia,2021-05-15,21214900,6983334,16611,14231566,194227,6983334,16611,14231566,194227
Czechia,2021-05-16,21298436,6998531,15197,14299905,68339,6998531,15197,14299905,68339
Czechia,2021-05-17,21389353,7005859,7328,14383494,83589,7005859,7328,14383494,83589
Czechia,2021-05-18,21701619,7036440,30581,14665179,281685,7036440,30581,14665179,281685
Czechia,2021-05-19,22005586,7066954,30514,14938632,273453,7066954,30514,14938632,273453
Czechia,2021-05-20,22272436,7088371,21417,15184065,245433,7088371,21417,15184065,245433
Czechia,2021-05-21,22549126,7111334,22963,15437792,253727,7111334,22963,15437792,253727
Czechia,2021-05-22,22782230,7134531,23197,15647699,209907,7134531,23197,15647699,209907
Czechia,2021-05-23,22860689,7146927,12396,15713762,66063,7146927,12396,15713762,66063
Czechia,2021-05-24,22950252,7154051,7124,15796201,82439,7154051,7124,15796201,82439
Czechia,2021-05-25,23250240,7180503,26452,16069737,273536,7180503,26452,16069737,273536
Czechia,2021-05-26,23511544,7201522,21019,16310022,240285,7201522,21019,16310022,240285
Czechia,2021-05-27,23752751,7224242,22720,16528509,218487,7224242,22720,16528509,218487
Czechia,2021-05-28,23993336,7244340,20098,16748996,220487,7244340,20098,16748996,220487
Czechia,2021-05-29,24208303,7264854,20514,16943449,194453,7264854,20514,16943449,194453
Czechia,2021-05-30,24286003,7275260,10406,17010743,67294,7275260,10406,17010743,67294
Czechia,2021-05-31,24373714,7279741,4481,17093973,83230,7279741,4481,17093973,83230
Czechia,2021-06-01,24676793,7308009,28268,17368784,274811,7308009,28268,17368784,274811
Czechia,2021-06-02,24925945,7331497,23488,17594448,225664,7331497,23488,17594448,225664
Czechia,2021-06-03,25139419,7352951,21454,17786468,192020,7352951,21454,17786468,192020
Czechia,2021-06-04,25358881,7385697,32746,17973184,186716,7385697,32746,17973184,186716
Czechia,2021-06-05,25544970,7409951,24254,18135019,161835,7409951,24254,18135019,161835
Czechia,2021-06-06,25617597,7421968,12017,18195629,60610,7421968,12017,18195629,60610
Czechia,2021-06-07,25703379,7428967,6999,18274412,78783,7428967,6999,18274412,78783
Czechia,2021-06-08,25953333,7457266,28299,18496067,221655,7457266,28299,18496067,221655
Czechia,2021-06-09,26152234,7485816,28550,18666418,170351,7485816,28550,18666418,170351
Czechia,2021-06-10,26335670,7510489,24673,18825181,158763,7510489,24673,18825181,158763
Czechia,2021-06-11,26527678,7534920,24431,18992758,167577,7534920,24431,18992758,167577
Czechia,2021-06-12,26727347,7562183,27263,19165164,172406,7562183,27263,19165164,172406
Czechia,2021-06-13,26789041,7574455,12272,19214586,49422,7574455,12272,19214586,49422
Czechia,2021-06-14,26855604,7580177,5722,19275427,60841,7580177,5722,19275427,60841
Czechia,2021-06-15,27067357,7608616,28439,19458741,183314,7608616,28439,19458741,183314
Czechia,2021-06-16,27263556,7641972,33356,19621584,162843,7641972,33356,19621584,162843
Czechia,2021-06-17,27431368,7663234,21262,19768134,146550,7663234,21262,19768134,146550
Czechia,2021-06-18,27635546,7704570,41336,19930976,162842,7704570,41336,19930976,162842
Czechia,2021-06-19,27838628,7741800,37230,20096828,165852,7741800,37230,20096828,165852
Czechia,2021-06-20,27904159,7756472,14672,20147687,50859,7756472,14672,20147687,50859
Czechia,2021-06-21,27956617,7764311,7839,20192306,44619,7764311,7839,20192306,44619
Czechia,2021-06-22,28147097,7795538,31227,20351559,159253,7795538,31227,20351559,159253
Czechia,2021-06-23,28305756,7822988,27450,20482768,131209,7822988,27450,20482768,131209
Czechia,2021-06-24,28465978,7847862,24874,20618116,135348,7847862,24874,20618116,135348
Czechia,2021-06-25,28624080,7876060,28198,20748020,129904,7876060,28198,20748020,129904
Czechia,2021-06-26,28784959,7904071,28011,20880888,132868,7904071,28011,20880888,132868
Czechia,2021-06-27,28856137,7926905,22834,20929232,48344,7926905,22834,20929232,48344
Czechia,2021-06-28,28906706,7935695,8790,20971011,41779,7935695,8790,20971011,41779
Czechia,2021-06-29,29083531,7965292,29597,21118239,147228,7965292,29597,21118239,147228
Czechia,2021-06-30,29236891,8006065,40773,21230826,112587,8006065,40773,21230826,112587
Czechia,2021-07-01,29875529,8042979,36914,21832550,601724,8042979,36914,21832550,601724
Czechia,2021-07-02,30017226,8087484,44505,21929742,97192,8087484,44505,21929742,97192
Czechia,2021-07-03,30186998,8135078,47594,22051920,122178,8135078,47594,22051920,122178
Czechia,2021-07-04,30265111,8171929,36851,22093182,41262,8171929,36851,22093182,41262
Czechia,2021-07-05,30314030,8184789,12860,22129241,36059,8184789,12860,22129241,36059
Czechia,2021-07-06,30361084,8196501,11712,22164583,35342,8196501,11712,22164583,35342
Czechia,2021-07-07,30405847,8206071,9570,22199776,35193,8206071,9570,22199776,35193
Czechia,2021-07-08,30489234,8228900,22829,22260334,60558,8228900,22829,22260334,60558
Czechia,2021-07-09,30584299,8260298,31398,22324001,63667,8260298,31398,22324001,63667
Denmark,2021-05-27,53350931,32345250,32345250,21005681,21005681,32345250,32345250,21005681,21005681
Denmark,2021-05-28,54031318,32494298,149048,21537020,531339,32494298,149048,21537020,531339
Denmark,2021-05-29,54031318,32494298,0,21537020,0,32494298,0,21537020,0
Denmark,2021-05-30,54031318,32494298,0,21537020,0,32494298,0,21537020,0
Denmark,2021-05-31,55581321,32952067,457769,22629254,1092234,32952067,457769,22629254,1092234
Denmark,2021-06-01,56243424,33083579,131512,23159845,530591,33083579,131512,23159845,530591
Denmark,2021-06-02,56790923,33218652,135073,23572271,412426,33218652,135073,23572271,412426
Denmark,2021-06-03,57304092,33345460,126808,23958632,386361,33345460,126808,23958632,386361
Denmark,2021-06-04,57966838,33506621,161161,24460217,501585,33506621,161161,24460217,501585
Denmark,2021-06-05,57966838,33506621,0,24460217,0,33506621,0,24460217,0
Denmark,2021-06-06,57966838,33506621,0,24460217,0,33506621,0,24460217,0
Denmark,2021-06-11,61491074,34367324,860703,27123750,2663533,34367324,860703,27123750,2663533
Denmark,2021-06-12,61491074,34367324,0,27123750,0,34367324,0,27123750,0
Denmark,2021-06-13,61491074,34367324,0,27123750,0,34367324,0,27123750,0
Denmark,2021-07-05,70173771,36486509,2119185,33687262,6563512,36486509,2119185,33687262,6563512
Denmark,2021-07-06,70459370,36570384,83875,33888986,201724,36570384,83875,33888986,201724
Denmark,2021-07-07,70738749,36667410,97026,34071339,182353,36667410,97026,34071339,182353
Denmark,2021-07-08,71023550,36759079,91669,34264471,193132,36759079,91669,34264471,193132
Denmark,2021-07-09,71287411,36859809,100730,34427602,163131,36859809,100730,34427602,163131
Greece,2021-06-02,9627393,14596,14596,30588,30588,14596,14596,30588,30588
Greece,2021-06-03,9673644,14647,51,31604,1016,14647,51,31604,1016
Greece,2021-06-04,9721452,14050,-597,33758,2154,14050,-597,33758,2154
Greece,2021-06-05,9771260,15151,1101,34657,899,15151,1101,34657,899
Greece,2021-06-06,9791765,6773,-8378,13732,-20925,6773,-8378,13732,-20925
Greece,2021-06-07,9812468,5236,-1537,15467,1735,5236,-1537,15467,1735
Greece,2021-06-08,9868380,18395,13159,37517,22050,18395,13159,37517,22050
Greece,2021-06-09,9910362,13926,-4469,28056,-9461,13926,-4469,28056,-9461
Greece,2021-06-10,9952216,13242,-684,28612,556,13242,-684,28612,556
Greece,2021-06-11,9994319,13650,408,28453,-159,13650,408,28453,-159
Greece,2021-06-12,10039094,14208,558,30567,2114,14208,558,30567,2114
Greece,2021-06-13,10059608,5953,-8255,14561,-16006,5953,-8255,14561,-16006
Greece,2021-06-14,10079010,4335,-1618,15067,506,4335,-1618,15067,506
Greece,2021-06-15,10129590,16393,12058,34187,19120,16393,12058,34187,19120
Greece,2021-06-16,10168315,12740,-3653,25985,-8202,12740,-3653,25985,-8202
Greece,2021-06-17,10207626,12520,-220,26791,806,12520,-220,26791,806
Greece,2021-06-18,10248295,12630,110,28039,1248,12630,110,28039,1248
Greece,2021-06-19,10289041,12108,-522,28638,599,12108,-522,28638,599
Greece,2021-06-20,10309057,4887,-7221,15129,-13509,4887,-7221,15129,-13509
Greece,2021-06-21,10324505,3947,-940,11501,-3628,3947,-940,11501,-3628
Greece,2021-06-22,10346864,7246,3299,15113,3612,7246,3299,15113,3612
Greece,2021-06-23,10392583,15582,8336,30137,15024,15582,8336,30137,15024
Greece,2021-06-24,10430875,12658,-2924,25634,-4503,12658,-2924,25634,-4503
Greece,2021-06-25,10468182,12592,-66,24715,-919,12592,-66,24715,-919
Greece,2021-06-26,10505135,10801,-1791,26152,1437,10801,-1791,26152,1437
Greece,2021-06-27,10528950,5711,-5090,18104,-8048,5711,-5090,18104,-8048
Greece,2021-06-28,10548412,4514,-1197,14948,-3156,4514,-1197,14948,-3156
Greece,2021-06-29,10593963,14223,9709,31328,16380,14223,9709,31328,16380
Greece,2021-06-30,10632619,11946,-2277,26710,-4618,11946,-2277,26710,-4618
Greece,2021-07-01,10674006,12349,403,29038,2328,12349,403,29038,2328
Greece,2021-07-02,10714146,12584,235,27556,-1482,12584,235,27556,-1482
Greece,2021-07-03,10757582,11358,-1226,32078,4522,11358,-1226,32078,4522
Greece,2021-07-04,10787512,5737,-5621,24193,-7885,5737,-5621,24193,-7885
Greece,2021-07-05,10813961,4841,-896,21608,-2585,4841,-896,21608,-2585
Greece,2021-07-06,10880425,15656,10815,50808,29200,15656,10815,50808,29200
Greece,2021-07-07,10940328,13578,-2078,46325,-4483,13578,-2078,46325,-4483
Greece,2021-07-08,11005339,13433,-145,51578,5253,13433,-145,51578,5253
Greece,2021-07-09,11074061,13456,23,55266,3688,13456,23,55266,3688
Indonesia,2021-05-27,16372837,14443495,14443495,1929342,1929342,14443495,14443495,1929342,1929342
Indonesia,2021-05-28,16483519,14496867,53372,1986652,57310,14496867,53372,1986652,57310
Indonesia,2021-05-29,16589465,14550421,53554,2039044,52392,14550421,53554,2039044,52392
Indonesia,2021-05-30,16660482,14590381,39960,2070101,31057,14590381,39960,2070101,31057
Indonesia,2021-05-31,16728343,14623238,32857,2105105,35004,14623238,32857,2105105,35004
Indonesia,2021-06-01,16804288,14662830,39592,2141458,36353,14662830,39592,2141458,36353
Indonesia,2021-06-02,16869118,14692548,29718,2176570,35112,14692548,29718,2176570,35112
Indonesia,2021-06-03,16964318,14752636,60088,2211682,35112,14752636,60088,2211682,35112
Indonesia,2021-06-04,16964318,14752636,0,2211682,0,14752636,0,2211682,0
Indonesia,2021-06-05,17171338,14867470,114834,2303868,92186,14867470,114834,2303868,92186
Indonesia,2021-06-06,17235561,14905006,37536,2330555,26687,14905006,37536,2330555,26687
Indonesia,2021-06-07,17299617,14938098,33092,2361519,30964,14938098,33092,2361519,30964
Indonesia,2021-06-08,17401548,14993704,55606,2407844,46325,14993704,55606,2407844,46325
Indonesia,2021-06-09,17509373,15055117,61413,2454256,46412,15055117,61413,2454256,46412
Indonesia,2021-06-10,17619996,15119217,64100,2500779,46523,15119217,64100,2500779,46523
Indonesia,2021-06-11,17735758,15181737,62520,2554021,53242,15181737,62520,2554021,53242
Indonesia,2021-06-12,17833717,15237192,55455,2596525,42504,15237192,55455,2596525,42504
Indonesia,2021-06-13,17904185,15282617,45425,2621568,25043,15282617,45425,2621568,25043
Indonesia,2021-06-14,17973499,15319220,36603,2654279,32711,15319220,36603,2654279,32711
Indonesia,2021-06-15,16704989,14565682,-753538,2139307,-514972,14565682,-753538,2139307,-514972
Indonesia,2021-06-16,18174981,15452879,887197,2722102,582795,15452879,887197,2722102,582795
Indonesia,2021-06-17,18305810,15528844,75965,2776966,54864,15528844,75965,2776966,54864
Indonesia,2021-06-18,18438025,15606477,77633,2831548,54582,15606477,77633,2831548,54582
Indonesia,2021-06-19,18560435,15679613,73136,2880822,49274,15679613,73136,2880822,49274
Indonesia,2021-06-20,18649618,15735333,55720,2914285,33463,15735333,55720,2914285,33463
Indonesia,2021-06-21,18734036,15783090,47757,2950946,36661,15783090,47757,2950946,36661
Indonesia,2021-06-22,18864666,15859150,76060,3005516,54570,15859150,76060,3005516,54570
Indonesia,2021-06-23,19005853,15947439,88289,3058414,52898,15947439,88289,3058414,52898
Indonesia,2021-06-24,19142749,16030869,83430,3111880,53466,16030869,83430,3111880,53466
Indonesia,2021-06-25,19283664,16118700,87831,3164964,53084,16118700,87831,3164964,53084
Indonesia,2021-06-26,19419298,16203773,85073,3215525,50561,16203773,85073,3215525,50561
Indonesia,2021-06-27,19518202,16267011,63238,3251191,35666,16267011,63238,3251191,35666
Indonesia,2021-06-28,19616389,16326119,59108,3290270,39079,16326119,59108,3290270,39079
Indonesia,2021-06-29,19760346,16412932,86813,3347414,57144,16412932,86813,3347414,57144
Indonesia,2021-06-30,19903077,16497987,85055,3405090,57676,16497987,85055,3405090,57676
Indonesia,2021-07-01,20058268,16596629,98642,3461639,56549,16596629,98642,3461639,56549
Indonesia,2021-07-02,20211876,16690268,93639,3521608,59969,16690268,93639,3521608,59969
Indonesia,2021-07-03,20369103,16794048,103780,3575055,53447,16794048,103780,3575055,53447
Indonesia,2021-07-04,20489937,16875347,81299,3614590,39535,16875347,81299,3614590,39535
Indonesia,2021-07-05,20600052,16947492,72145,3652560,37970,16947492,72145,3652560,37970
Indonesia,2021-07-06,20783105,17066516,119024,3716589,64029,17066516,119024,3716589,64029
Indonesia,2021-07-07,20982248,17200095,133579,3782153,65564,17200095,133579,3782153,65564
Indonesia,2021-07-08,21182629,17334669,134574,3847960,65807,17334669,134574,3847960,65807
Indonesia,2021-07-09,21402544,17487494,152825,3915050,67090,17487494,152825,3915050,67090
Italy,2021-06-02,66620345,49495271,49495271,17125074,17125074,49495271,49495271,17125074,17125074
Italy,2021-06-03,66717978,49557296,62025,17160682,35608,49557296,62025,17160682,35608
Italy,2021-06-04,66938917,49661208,103912,17277709,117027,49661208,103912,17277709,117027
Italy,2021-06-05,67177549,49774399,113191,17403150,125441,49774399,113191,17403150,125441
Italy,2021-06-06,67327507,49862425,88026,17465082,61932,49862425,88026,17465082,61932
Italy,2021-06-07,67412074,49912181,49756,17499893,34811,49912181,49756,17499893,34811
Italy,2021-06-08,67632991,50013870,101689,17619121,119228,50013870,101689,17619121,119228
Italy,2021-06-09,67851729,50136828,122958,17714901,95780,50136828,122958,17714901,95780
Italy,2021-06-10,68057064,50244071,107243,17812993,98092,50244071,107243,17812993,98092
Italy,2021-06-11,68257459,50341628,97557,17915831,102838,50341628,97557,17915831,102838
Italy,2021-06-12,68470425,50436753,95125,18033672,117841,50436753,95125,18033672,117841
Italy,2021-06-13,68604561,50510527,73774,18094034,60362,50510527,73774,18094034,60362
Italy,2021-06-14,68684085,50555019,44492,18129066,35032,50555019,44492,18129066,35032
Italy,2021-06-15,68896197,50656352,101333,18239845,110779,50656352,101333,18239845,110779
Italy,2021-06-16,69099370,50764084,107732,18335286,95441,50764084,107732,18335286,95441
Italy,2021-06-17,69299685,50864061,99977,18435624,100338,50864061,99977,18435624,100338
Italy,2021-06-18,69515711,50952072,88011,18563639,128015,50952072,88011,18563639,128015
Italy,2021-06-19,69765699,51042709,90637,18722990,159351,51042709,90637,18722990,159351
Italy,2021-06-20,69916221,51109726,67017,18806495,83505,51109726,67017,18806495,83505
Italy,2021-06-21,69997973,51149035,39309,18848938,42443,51149035,39309,18848938,42443
Italy,2021-06-22,70190855,51242092,93057,18948763,99825,51242092,93057,18948763,99825
Italy,2021-06-23,70388886,51346290,104198,19042596,93833,51346290,104198,19042596,93833
Italy,2021-06-24,70577077,51428966,82676,19148111,105515,51428966,82676,19148111,105515
Italy,2021-06-25,70769618,51505508,76542,19264110,115999,51505508,76542,19264110,115999
Italy,2021-06-26,70994111,51585935,80427,19408176,144066,51585935,80427,19408176,144066
Italy,2021-06-27,71132502,51648557,62622,19483945,75769,51648557,62622,19483945,75769
Italy,2021-06-28,71207555,51686201,37644,19521354,37409,51686201,37644,19521354,37409
Italy,2021-06-29,71398190,51772454,86253,19625736,104382,51772454,86253,19625736,104382
Italy,2021-06-30,71583206,51864808,92354,19718398,92662,51864808,92354,19718398,92662
Italy,2021-07-01,71771680,51953621,88813,19818059,99661,51953621,88813,19818059,99661
Italy,2021-07-02,71970918,52036180,82559,19934738,116679,52036180,82559,19934738,116679
Italy,2021-07-03,72199045,52121065,84885,20077980,143242,52121065,84885,20077980,143242
Italy,2021-07-04,72340685,52185355,64290,20155330,77350,52185355,64290,20155330,77350
Italy,2021-07-05,72415334,52219735,34380,20195599,40269,52219735,34380,20195599,40269
Italy,2021-07-06,72607758,52306087,86352,20301671,106072,52306087,86352,20301671,106072
Italy,2021-07-07,72785735,52395134,89047,20390601,88930,52395134,89047,20390601,88930
Italy,2021-07-08,72960587,52481505,86371,20479082,88481,52481505,86371,20479082,88481
Italy,2021-07-09,73157509,52563607,82102,20593902,114820,52563607,82102,20593902,114820
Lithuania,2021-03-23,2294648,2246813,2246813,47835,47835,2246813,2246813,47835,47835
Lithuania,2021-03-24,2303779,2255040,8227,48739,904,2255040,8227,48739,904
Lithuania,2021-03-25,2312965,2263054,8014,49911,1172,2263054,8014,49911,1172
Lithuania,2021-03-26,2322847,2271964,8910,50883,972,2271964,8910,50883,972
Lithuania,2021-03-27,2335804,2281732,9768,54072,3189,2281732,9768,54072,3189
Lithuania,2021-03-28,2344310,2289122,7390,55188,1116,2289122,7390,55188,1116
Lithuania,2021-03-29,2349847,2293605,4483,56242,1054,2293605,4483,56242,1054
Lithuania,2021-03-30,2360989,2301236,7631,59753,3511,2301236,7631,59753,3511
Lithuania,2021-03-31,2375342,2311399,10163,63943,4190,2311399,10163,63943,4190
Lithuania,2021-04-01,2389769,2321216,9817,68553,4610,2321216,9817,68553,4610
Lithuania,2021-04-02,2404822,2331493,10277,73329,4776,2331493,10277,73329,4776
Lithuania,2021-04-03,2420206,2341967,10474,78239,4910,2341967,10474,78239,4910
Lithuania,2021-04-04,2428457,2347588,5621,80869,2630,2347588,5621,80869,2630
Lithuania,2021-04-05,2433337,2351362,3774,81975,1106,2351362,3774,81975,1106
Lithuania,2021-04-06,2439009,2355155,3793,83854,1879,2355155,3793,83854,1879
Lithuania,2021-04-07,2454232,2364123,8968,90109,6255,2364123,8968,90109,6255
Lithuania,2021-04-08,2471587,2374575,10452,97012,6903,2374575,10452,97012,6903
Lithuania,2021-04-09,2489297,2385962,11387,103335,6323,2385962,11387,103335,6323
Lithuania,2021-04-10,2507855,2397265,11303,110590,7255,2397265,11303,110590,7255
Lithuania,2021-04-11,2519087,2404313,7048,114774,4184,2404313,7048,114774,4184
Lithuania,2021-04-12,2527967,2410591,6278,117376,2602,2410591,6278,117376,2602
Lithuania,2021-04-13,2546234,2421284,10693,124950,7574,2421284,10693,124950,7574
Lithuania,2021-04-14,2567678,2434983,13699,132695,7745,2434983,13699,132695,7745
Lithuania,2021-04-15,2586250,2445668,10685,140582,7887,2445668,10685,140582,7887
Lithuania,2021-04-16,2606339,2457663,11995,148676,8094,2457663,11995,148676,8094
Lithuania,2021-04-17,2626203,2469184,11521,157019,8343,2469184,11521,157019,8343
Lithuania,2021-04-18,2641378,2478901,9717,162477,5458,2478901,9717,162477,5458
Lithuania,2021-04-19,2650048,2484198,5297,165850,3373,2484198,5297,165850,3373
Lithuania,2021-04-20,2669941,2494915,10717,175026,9176,2494915,10717,175026,9176
Lithuania,2021-05-19,3248813,2857438,362523,391375,216349,2857438,362523,391375,216349
Lithuania,2021-05-20,3278878,2877262,19824,401616,10241,2877262,19824,401616,10241
Lithuania,2021-05-21,3299318,2890942,13680,408376,6760,2890942,13680,408376,6760
Lithuania,2021-05-22,3326083,2910693,19751,415390,7014,2910693,19751,415390,7014
Lithuania,2021-05-23,3336463,2918151,7458,418312,2922,2918151,7458,418312,2922
Lithuania,2021-05-24,3342360,2921301,3150,421059,2747,2921301,3150,421059,2747
Lithuania,2021-05-25,3362757,2931594,10293,431163,10104,2931594,10293,431163,10104
Lithuania,2021-05-26,3389285,2949292,17698,439993,8830,2949292,17698,439993,8830
Lithuania,2021-05-27,3416169,2969165,19873,447004,7011,2969165,19873,447004,7011
Lithuania,2021-05-28,3438548,2984755,15590,453793,6789,2984755,15590,453793,6789
Lithuania,2021-05-29,3464015,3000383,15628,463632,9839,3000383,15628,463632,9839
Lithuania,2021-05-30,3474616,3006318,5935,468298,4666,3006318,5935,468298,4666
Lithuania,2021-05-31,3480438,3008817,2499,471621,3323,3008817,2499,471621,3323
Lithuania,2021-06-01,3503963,3022592,13775,481371,9750,3022592,13775,481371,9750
Lithuania,2021-06-02,3529137,3040405,17813,488732,7361,3040405,17813,488732,7361
Lithuania,2021-06-03,3553949,3059231,18826,494718,5986,3059231,18826,494718,5986
Lithuania,2021-06-04,3577838,3076086,16855,501752,7034,3076086,16855,501752,7034
Lithuania,2021-06-05,3599328,3088688,12602,510640,8888,3088688,12602,510640,8888
Lithuania,2021-06-06,3610554,3095287,6599,515267,4627,3095287,6599,515267,4627
Lithuania,2021-06-07,3615913,3097663,2376,518250,2983,3097663,2376,518250,2983
Lithuania,2021-06-08,3634155,3107807,10144,526348,8098,3107807,10144,526348,8098
Lithuania,2021-06-09,3657762,3125498,17691,532264,5916,3125498,17691,532264,5916
Lithuania,2021-06-10,3680457,3142134,16636,538323,6059,3142134,16636,538323,6059
Lithuania,2021-06-11,3701531,3156388,14254,545143,6820,3156388,14254,545143,6820
Lithuania,2021-06-12,3722345,3168538,12150,553807,8664,3168538,12150,553807,8664
Lithuania,2021-06-13,3730752,3172899,4361,557853,4046,3172899,4361,557853,4046
Lithuania,2021-06-14,3735065,3174956,2057,560109,2256,3174956,2057,560109,2256
Lithuania,2021-06-15,3750830,3183361,8405,567469,7360,3183361,8405,567469,7360
Lithuania,2021-06-16,3765215,3192975,9614,572240,4771,3192975,9614,572240,4771
Lithuania,2021-06-17,3776991,3200421,7446,576570,4330,3200421,7446,576570,4330
Lithuania,2021-06-18,3789030,3206797,6376,582233,5663,3206797,6376,582233,5663
Lithuania,2021-06-19,3803596,3212949,6152,590647,8414,3212949,6152,590647,8414
Lithuania,2021-06-20,3811078,3216715,3766,594363,3716,3216715,3766,594363,3716
Lithuania,2021-06-21,3814520,3218576,1861,595944,1581,3218576,1861,595944,1581
Lithuania,2021-06-22,3825102,3223887,5311,601215,5271,3223887,5311,601215,5271
Lithuania,2021-06-23,3835962,3230631,6744,605331,4116,3230631,6744,605331,4116
Lithuania,2021-06-24,3846685,3236295,5664,610390,5059,3236295,5664,610390,5059
Lithuania,2021-06-25,3851728,3239113,2818,612615,2225,3239113,2818,612615,2225
Lithuania,2021-06-26,3864165,3244061,4948,620104,7489,3244061,4948,620104,7489
Lithuania,2021-06-27,3870496,3247308,3247,623188,3084,3247308,3247,623188,3084
Lithuania,2021-06-28,3874278,3249364,2056,624914,1726,3249364,2056,624914,1726
Lithuania,2021-06-29,3885715,3255049,5685,630666,5752,3255049,5685,630666,5752
Lithuania,2021-06-30,3896037,3261408,6359,634629,3963,3261408,6359,634629,3963
Lithuania,2021-07-01,3904874,3266274,4866,638600,3971,3266274,4866,638600,3971
Lithuania,2021-07-02,3913805,3270883,4609,642922,4322,3270883,4609,642922,4322
Lithuania,2021-07-03,3926253,3276166,5283,650087,7165,3276166,5283,650087,7165
Lithuania,2021-07-04,3932272,3279131,2965,653141,3054,3279131,2965,653141,3054
Lithuania,2021-07-05,3935252,3280904,1773,654348,1207,3280904,1773,654348,1207
Lithuania,2021-07-06,3946341,3287084,6180,659257,4909,3287084,6180,659257,4909
Lithuania,2021-07-07,3950624,3289787,2703,660837,1580,3289787,2703,660837,1580
Lithuania,2021-07-08,3959797,3295381,5594,664416,3579,3295381,5594,664416,3579
Lithuania,2021-07-09,3970218,3301885,6504,668333,3917,3301885,6504,668333,3917
Romania,2021-03-22,7001817,6494782,6494782,507035,507035,6494782,6494782,507035,507035
Romania,2021-03-23,7040517,6520795,26013,519722,12687,6520795,26013,519722,12687
Romania,2021-03-24,7080758,6549158,28363,531600,11878,6549158,28363,531600,11878
Romania,2021-03-25,7122737,6579391,30233,543346,11746,6579391,30233,543346,11746
Romania,2021-03-26,7163451,6609165,29774,554286,10940,6609165,29774,554286,10940
Romania,2021-03-28,7222072,6650078,40913,571994,17708,6650078,40913,571994,17708
Romania,2021-03-29,7236427,6658431,8353,577996,6002,6658431,8353,577996,6002
Romania,2021-03-30,7276814,6685665,27234,591149,13153,6685665,27234,591149,13153
Romania,2021-04-02,7400084,6773863,88198,626221,35072,6773863,88198,626221,35072
Romania,2021-04-03,7437427,6800572,26709,636855,10634,6800572,26709,636855,10634
Romania,2021-04-04,7459074,6816552,15980,642522,5667,6816552,15980,642522,5667
Romania,2021-04-07,7550873,6878550,61998,672323,29801,6878550,61998,672323,29801
Romania,2021-04-08,7591365,6907828,29278,683537,11214,6907828,29278,683537,11214
Romania,2021-04-10,7666540,6962658,54830,703882,20345,6962658,54830,703882,20345
Romania,2021-04-11,7687854,6978229,15571,709625,5743,6978229,15571,709625,5743
Romania,2021-04-12,7700501,6985435,7206,715066,5441,6985435,7206,715066,5441
Romania,2021-04-13,7736296,7009325,23890,726971,11905,7009325,23890,726971,11905
Romania,2021-04-14,7773502,7035734,26409,737768,10797,7035734,26409,737768,10797
Romania,2021-04-15,7811019,7061866,26132,749153,11385,7061866,26132,749153,11385
Romania,2021-04-16,7847540,7086549,24683,760991,11838,7086549,24683,760991,11838
Romania,2021-04-17,7883209,7110458,23909,772751,11760,7110458,23909,772751,11760
Romania,2021-04-18,7902628,7124135,13677,778493,5742,7124135,13677,778493,5742
Romania,2021-04-20,7950663,7154381,30246,796282,17789,7154381,30246,796282,17789
Romania,2021-04-21,7985507,7178943,24562,806564,10282,7178943,24562,806564,10282
Romania,2021-05-25,8908274,7794370,615427,1113904,307340,7794370,615427,1113904,307340
Romania,2021-05-27,8972481,7837772,43402,1134709,20805,7837772,43402,1134709,20805
Slovakia,2021-03-22,22580500,2268611,2268611,20311889,20311889,2268611,2268611,20311889,20311889
Slovakia,2021-03-23,22909120,2279486,10875,20629634,317745,2279486,10875,20629634,317745
Slovakia,2021-03-24,23128218,2290864,11378,20837354,207720,2290864,11378,20837354,207720
Slovakia,2021-03-25,23328365,2300975,10111,21027390,190036,2300975,10111,21027390,190036
Slovakia,2021-03-26,23512736,2310054,9079,21202682,175292,2310054,9079,21202682,175292
Slovakia,2021-03-27,23836249,2322443,12389,21513806,311124,2322443,12389,21513806,311124
Slovakia,2021-03-28,24435035,2329530,7087,22105505,591699,2329530,7087,22105505,591699
Slovakia,2021-03-29,24770315,2331828,2298,22438487,332982,2331828,2298,22438487,332982
Slovakia,2021-03-30,25132752,2340533,8705,22792219,353732,2340533,8705,22792219,353732
Slovakia,2021-03-31,25378086,2351940,11407,23026146,233927,2351940,11407,23026146,233927
Slovakia,2021-04-01,25634349,2360594,8654,23273755,247609,2360594,8654,23273755,247609
Slovakia,2021-04-02,25915186,2373463,12869,23541723,267968,2373463,12869,23541723,267968
Slovakia,2021-04-03,26096234,2379759,6296,23716475,174752,2379759,6296,23716475,174752
Slovakia,2021-04-04,26711901,2384180,4421,24327721,611246,2384180,4421,24327721,611246
Slovakia,2021-04-05,26926375,2386011,1831,24540364,212643,2386011,1831,24540364,212643
Slovakia,2021-04-06,27043526,2389156,3145,24654370,114006,2389156,3145,24654370,114006
Slovakia,2021-04-07,27418747,2399863,10707,25018884,364514,2399863,10707,25018884,364514
Slovakia,2021-04-08,27641040,2411744,11881,25229296,210412,2411744,11881,25229296,210412
Slovakia,2021-04-09,27826872,2420747,9003,25406125,176829,2420747,9003,25406125,176829
Slovakia,2021-04-10,28114203,2432500,11753,25681703,275578,2432500,11753,25681703,275578
Slovakia,2021-04-11,28702887,2439970,7470,26262917,581214,2439970,7470,26262917,581214
Slovakia,2021-04-12,29058959,2441472,1502,26617487,354570,2441472,1502,26617487,354570
Slovakia,2021-04-13,29383409,2449747,8275,26933662,316175,2449747,8275,26933662,316175
Slovakia,2021-04-14,29580364,2458340,8593,27122024,188362,2458340,8593,27122024,188362
Slovakia,2021-04-15,29797625,2465652,7312,27331973,209949,2465652,7312,27331973,209949
Slovakia,2021-04-16,29992550,2473314,7662,27519236,187263,2473314,7662,27519236,187263
Slovakia,2021-04-17,30310903,2486691,13377,27824212,304976,2486691,13377,27824212,304976
Slovakia,2021-04-18,30885802,2503748,17057,28382054,557842,2503748,17057,28382054,557842
Slovakia,2021-04-19,31277633,2505182,1434,28772451,390397,2505182,1434,28772451,390397
Slovakia,2021-04-20,31596512,2513141,7959,29083371,310920,2513141,7959,29083371,310920
Slovakia,2021-04-21,31823684,2520570,7429,29303114,219743,2520570,7429,29303114,219743
Slovakia,2021-04-22,31977104,2527366,6796,29449738,146624,2527366,6796,29449738,146624
Slovakia,2021-04-23,32115483,2533929,6563,29581554,131816,2533929,6563,29581554,131816
Slovakia,2021-04-24,32432957,2548241,14312,29884716,303162,2548241,14312,29884716,303162
Slovakia,2021-04-25,32970534,2578835,30594,30391699,506983,2578835,30594,30391699,506983
Slovakia,2021-04-26,33356097,2589457,10622,30766640,374941,2589457,10622,30766640,374941
Slovakia,2021-04-27,33687664,2597742,8285,31089922,323282,2597742,8285,31089922,323282
Slovakia,2021-04-28,33838694,2605250,7508,31233444,143522,2605250,7508,31233444,143522
Slovakia,2021-04-29,33997566,2611807,6557,31385759,152315,2611807,6557,31385759,152315
Slovakia,2021-04-30,34163391,2620819,9012,31542572,156813,2620819,9012,31542572,156813
Slovakia,2021-05-01,34435551,2629250,8431,31806301,263729,2629250,8431,31806301,263729
Slovakia,2021-05-02,34829241,2664217,34967,32165024,358723,2664217,34967,32165024,358723
Slovakia,2021-05-03,35107484,2676393,12176,32431091,266067,2676393,12176,32431091,266067
Slovakia,2021-05-04,35345283,2683618,7225,32661665,230574,2683618,7225,32661665,230574
Slovakia,2021-05-05,35484585,2691638,8020,32792947,131282,2691638,8020,32792947,131282
Slovakia,2021-05-06,35586326,2697906,6268,32888420,95473,2697906,6268,32888420,95473
Slovakia,2021-05-07,35687155,2704901,6995,32982254,93834,2704901,6995,32982254,93834
Slovakia,2021-05-08,35854003,2717033,12132,33136970,154716,2717033,12132,33136970,154716
Slovakia,2021-05-09,36011159,2720699,3666,33290460,153490,2720699,3666,33290460,153490
Slovakia,2021-05-10,36172666,2726117,5418,33446549,156089,2726117,5418,33446549,156089
Slovakia,2021-05-11,36355448,2734112,7995,33621336,174787,2734112,7995,33621336,174787
Slovakia,2021-05-12,36463030,2740888,6776,33722142,100806,2740888,6776,33722142,100806
Slovakia,2021-05-13,36571318,2745856,4968,33825462,103320,2745856,4968,33825462,103320
Slovakia,2021-05-14,36661382,2752948,7092,33908434,82972,2752948,7092,33908434,82972
Slovakia,2021-05-15,36800878,2759676,6728,34041202,132768,2759676,6728,34041202,132768
Slovakia,2021-05-16,36952728,2762414,2738,34190314,149112,2762414,2738,34190314,149112
Slovakia,2021-05-17,37083843,2765568,3154,34318275,127961,2765568,3154,34318275,127961
Slovakia,2021-05-18,37250140,2772844,7276,34477296,159021,2772844,7276,34477296,159021
Slovakia,2021-05-19,37342875,2778680,5836,34564195,86899,2778680,5836,34564195,86899
Slovakia,2021-05-20,37430864,2784277,5597,34646587,82392,2784277,5597,34646587,82392
Slovakia,2021-05-21,37503734,2788281,4004,34715453,68866,2788281,4004,34715453,68866
Slovakia,2021-05-22,37609448,2793952,5671,34815496,100043,2793952,5671,34815496,100043
Slovakia,2021-05-23,37707686,2798074,4122,34909612,94116,2798074,4122,34909612,94116
Slovakia,2021-05-24,37810468,2799241,1167,35011227,101615,2799241,1167,35011227,101615
Slovakia,2021-05-25,37922632,2805853,6612,35116779,105552,2805853,6612,35116779,105552
Slovakia,2021-05-26,38002260,2812008,6155,35190252,73473,2812008,6155,35190252,73473
Slovakia,2021-05-27,38075805,2816985,4977,35258820,68568,2816985,4977,35258820,68568
Slovakia,2021-05-28,38137735,2821167,4182,35316568,57748,2821167,4182,35316568,57748
Slovakia,2021-05-29,38137735,2821167,0,35316568,0,2821167,0,35316568,0
Slovakia,2021-05-30,38313469,2829751,8584,35483718,167150,2829751,8584,35483718,167150
Slovakia,2021-05-31,38389363,2831060,1309,35558303,74585,2831060,1309,35558303,74585
Slovakia,2021-06-01,38478578,2838146,7086,35640432,82129,2838146,7086,35640432,82129
Slovakia,2021-06-02,38540820,2843402,5256,35697418,56986,2843402,5256,35697418,56986
Slovakia,2021-06-03,38595394,2848668,5266,35746726,49308,2848668,5266,35746726,49308
Slovakia,2021-06-04,38652398,2854008,5340,35798390,51664,2854008,5340,35798390,51664
Slovakia,2021-06-05,38728884,2859556,5548,35869328,70938,2859556,5548,35869328,70938
Slovakia,2021-06-06,38792441,2862336,2780,35930105,60777,2862336,2780,35930105,60777
Slovakia,2021-06-07,38857279,2863317,981,35993962,63857,2863317,981,35993962,63857
Slovakia,2021-06-08,38925577,2869093,5776,36056484,62522,2869093,5776,36056484,62522
Slovakia,2021-06-09,38982445,2875030,5937,36107415,50931,2875030,5937,36107415,50931
Slovakia,2021-06-10,39044130,2879548,4518,36164582,57167,2879548,4518,36164582,57167
Slovakia,2021-06-11,39080975,2883850,4302,36197125,32543,2883850,4302,36197125,32543
Slovakia,2021-06-12,39154068,2889713,5863,36264355,67230,2889713,5863,36264355,67230
Slovakia,2021-06-13,39212294,2892229,2516,36320065,55710,2892229,2516,36320065,55710
Slovakia,2021-06-14,39264330,2893322,1093,36371008,50943,2893322,1093,36371008,50943
Slovakia,2021-06-15,39331415,2899336,6014,36432079,61071,2899336,6014,36432079,61071
Slovakia,2021-06-16,39381244,2903570,4234,36477674,45595,2903570,4234,36477674,45595
Slovakia,2021-06-17,39431800,2907942,4372,36523858,46184,2907942,4372,36523858,46184
Slovakia,2021-06-18,39476574,2911736,3794,36564838,40980,2911736,3794,36564838,40980
Slovakia,2021-06-19,39476574,2911736,0,36564838,0,2911736,0,36564838,0
Slovakia,2021-06-20,39476574,2911736,0,36564838,0,2911736,0,36564838,0
Slovakia,2021-06-21,39628152,2920840,9104,36707312,142474,2920840,9104,36707312,142474
Slovakia,2021-06-22,39692928,2926911,6071,36766017,58705,2926911,6071,36766017,58705
Slovakia,2021-06-23,39728631,2931288,4377,36797343,31326,2931288,4377,36797343,31326
Slovakia,2021-06-24,39773159,2935496,4208,36837663,40320,2935496,4208,36837663,40320
Slovakia,2021-06-25,39815370,2938855,3359,36876515,38852,2938855,3359,36876515,38852
Slovakia,2021-06-26,39865966,2944540,5685,36921426,44911,2944540,5685,36921426,44911
Slovakia,2021-06-27,39901442,2947093,2553,36954349,32923,2947093,2553,36954349,32923
Slovakia,2021-06-28,39937111,2947897,804,36989214,34865,2947897,804,36989214,34865
Slovakia,2021-06-29,39993348,2953485,5588,37039863,50649,2953485,5588,37039863,50649
Slovakia,2021-06-30,39910450,2959472,5987,36950978,-88885,2959472,5987,36950978,-88885
Slovakia,2021-07-01,40104232,2964856,5384,37139376,188398,2964856,5384,37139376,188398
Slovakia,2021-07-02,40127098,2970298,5442,37156800,17424,2970298,5442,37156800,17424
Slovakia,2021-07-03,40152642,2978570,8272,37174072,17272,2978570,8272,37174072,17272
Slovakia,2021-07-04,40152642,2978570,0,37174072,0,2978570,0,37174072,0
Slovakia,2021-07-05,40175589,2984432,5862,37191157,17085,2984432,5862,37191157,17085
Slovakia,2021-07-06,40186557,2987321,2889,37199236,8079,2987321,2889,37199236,8079
Slovakia,2021-07-07,40204368,2992958,5637,37211410,12174,2992958,5637,37211410,12174
Slovakia,2021-07-08,40226869,2998203,5245,37228666,17256,2998203,5245,37228666,17256
Slovakia,2021-07-09,40240845,3003874,5671,37236971,8305,3003874,5671,37236971,8305
Slovenia,2021-03-22,2374234,1009188,1009188,1365046,1365046,1009188,1009188,1365046,1365046
Slovenia,2021-03-23,2427812,1014210,5022,1413602,48556,1014210,5022,1413602,48556
Slovenia,2021-03-24,2462511,1021189,6979,1441322,27720,1021189,6979,1441322,27720
Slovenia,2021-03-25,2500287,1027621,6432,1472666,31344,1027621,6432,1472666,31344
Slovenia,2021-03-26,2535274,1034258,6637,1501016,28350,1034258,6637,1501016,28350
Slovenia,2021-03-27,2575248,1041034,6776,1534214,33198,1041034,6776,1534214,33198
Slovenia,2021-03-28,2586119,1044495,3461,1541624,7410,1044495,3461,1541624,7410
Slovenia,2021-03-29,2594516,1046269,1774,1548247,6623,1046269,1774,1548247,6623
Slovenia,2021-03-30,2648501,1051664,5395,1596837,48590,1051664,5395,1596837,48590
Slovenia,2021-03-31,2682080,1058870,7206,1623210,26373,1058870,7206,1623210,26373
Slovenia,2021-04-01,2710785,1064492,5622,1646293,23083,1064492,5622,1646293,23083
Slovenia,2021-04-02,2735587,1069845,5353,1665742,19449,1069845,5353,1665742,19449
Slovenia,2021-04-03,2760368,1074848,5003,1685520,19778,1074848,5003,1685520,19778
Slovenia,2021-04-04,2767404,1077645,2797,1689759,4239,1077645,2797,1689759,4239
Slovenia,2021-04-05,2770334,1079181,1536,1691153,1394,1079181,1536,1691153,1394
Slovenia,2021-04-06,2775896,1081060,1879,1694836,3683,1081060,1879,1694836,3683
Slovenia,2021-04-07,2811624,1085872,4812,1725752,30916,1085872,4812,1725752,30916
Slovenia,2021-04-08,2839758,1091232,5360,1748526,22774,1091232,5360,1748526,22774
Slovenia,2021-04-09,2867308,1096430,5198,1770878,22352,1096430,5198,1770878,22352
Slovenia,2021-04-10,2899648,1101160,4730,1798488,27610,1101160,4730,1798488,27610
Slovenia,2021-04-11,2910284,1104024,2864,1806260,7772,1104024,2864,1806260,7772
Slovenia,2021-04-12,2917836,1105508,1484,1812328,6068,1105508,1484,1812328,6068
Slovenia,2021-04-13,2967695,1110096,4588,1857599,45271,1110096,4588,1857599,45271
Slovenia,2021-04-14,2997904,1115402,5306,1882502,24903,1115402,5306,1882502,24903
Slovenia,2021-04-15,3027200,1119680,4278,1907520,25018,1119680,4278,1907520,25018
Slovenia,2021-04-16,3056906,1123933,4253,1932973,25453,1123933,4253,1932973,25453
Slovenia,2021-04-17,3095660,1127685,3752,1967975,35002,1127685,3752,1967975,35002
Slovenia,2021-04-18,3105803,1130305,2620,1975498,7523,1130305,2620,1975498,7523
Slovenia,2021-04-19,3114203,1131910,1605,1982293,6795,1131910,1605,1982293,6795
Slovenia,2021-04-20,3158313,1135447,3537,2022866,40573,1135447,3537,2022866,40573
Slovenia,2021-04-21,3190307,1140285,4838,2050022,27156,1140285,4838,2050022,27156
Slovenia,2021-04-22,3221939,1144543,4258,2077396,27374,1144543,4258,2077396,27374
Slovenia,2021-04-23,3259848,1151493,6950,2108355,30959,1151493,6950,2108355,30959
Slovenia,2021-04-24,3308350,1156673,5180,2151677,43322,1156673,5180,2151677,43322
Slovenia,2021-04-25,3320562,1159363,2690,2161199,9522,1159363,2690,2161199,9522
Slovenia,2021-04-26,3328568,1160717,1354,2167851,6652,1160717,1354,2167851,6652
Slovenia,2021-04-27,3364821,1164370,3653,2200451,32600,1164370,3653,2200451,32600
Slovenia,2021-04-28,3371271,1166377,2007,2204894,4443,1166377,2007,2204894,4443
Slovenia,2021-04-29,3410993,1170314,3937,2240679,35785,1170314,3937,2240679,35785
Slovenia,2021-04-30,3448776,1174756,4442,2274020,33341,1174756,4442,2274020,33341
Slovenia,2021-05-01,3488998,1178953,4197,2310045,36025,1178953,4197,2310045,36025
Slovenia,2021-05-02,3496430,1180780,1827,2315650,5605,1180780,1827,2315650,5605
Slovenia,2021-05-03,3505109,1182160,1380,2322949,7299,1182160,1380,2322949,7299
Slovenia,2021-05-04,3555342,1186184,4024,2369158,46209,1186184,4024,2369158,46209
Slovenia,2021-05-05,3587352,1190939,4755,2396413,27255,1190939,4755,2396413,27255
Slovenia,2021-05-06,3622285,1195168,4229,2427117,30704,1195168,4229,2427117,30704
Slovenia,2021-05-07,3658420,1199197,4029,2459223,32106,1199197,4029,2459223,32106
Slovenia,2021-05-08,3702602,1203524,4327,2499078,39855,1203524,4327,2499078,39855
Slovenia,2021-05-09,3713944,1205930,2406,2508014,8936,1205930,2406,2508014,8936
Slovenia,2021-05-10,3722637,1207240,1310,2515397,7383,1207240,1310,2515397,7383
Slovenia,2021-05-11,3771768,1210882,3642,2560886,45489,1210882,3642,2560886,45489
Slovenia,2021-05-12,3804887,1215660,4778,2589227,28341,1215660,4778,2589227,28341
Slovenia,2021-05-13,3839630,1220298,4638,2619332,30105,1220298,4638,2619332,30105
Slovenia,2021-05-14,3874926,1224259,3961,2650667,31335,1224259,3961,2650667,31335
Slovenia,2021-05-15,3921889,1228436,4177,2693453,42786,1228436,4177,2693453,42786
Slovenia,2021-05-16,3933930,1230907,2471,2703023,9570,1230907,2471,2703023,9570
Slovenia,2021-05-17,3942990,1232411,1504,2710579,7556,1232411,1504,2710579,7556
Slovenia,2021-05-18,3992198,1236643,4232,2755555,44976,1236643,4232,2755555,44976
Slovenia,2021-05-19,4026829,1241112,4469,2785717,30162,1241112,4469,2785717,30162
Slovenia,2021-05-20,4060952,1244964,3852,2815988,30271,1244964,3852,2815988,30271
Slovenia,2021-05-21,4102985,1249100,4136,2853885,37897,1249100,4136,2853885,37897
Slovenia,2021-05-22,4151440,1252905,3805,2898535,44650,1252905,3805,2898535,44650
Slovenia,2021-05-23,4163636,1255260,2355,2908376,9841,1255260,2355,2908376,9841
Slovenia,2021-05-24,4172408,1256665,1405,2915743,7367,1256665,1405,2915743,7367
Slovenia,2021-05-25,4221468,1260223,3558,2961245,45502,1260223,3558,2961245,45502
Slovenia,2021-05-26,4255513,1264460,4237,2991053,29808,1264460,4237,2991053,29808
Slovenia,2021-05-27,4291136,1268472,4012,3022664,31611,1268472,4012,3022664,31611
Slovenia,2021-05-28,4329417,1272058,3586,3057359,34695,1272058,3586,3057359,34695
Slovenia,2021-05-29,4379393,1275760,3702,3103633,46274,1275760,3702,3103633,46274
Slovenia,2021-05-30,4389901,1277612,1852,3112289,8656,1277612,1852,3112289,8656
Slovenia,2021-05-31,4399594,1279116,1504,3120478,8189,1279116,1504,3120478,8189
Slovenia,2021-06-01,4447382,1282498,3382,3164884,44406,1282498,3382,3164884,44406
Slovenia,2021-06-02,4478682,1286664,4166,3192018,27134,1286664,4166,3192018,27134
Slovenia,2021-06-03,4510076,1290501,3837,3219575,27557,1290501,3837,3219575,27557
Slovenia,2021-06-04,4547029,1294416,3915,3252613,33038,1294416,3915,3252613,33038
Slovenia,2021-06-05,4594972,1297880,3464,3297092,44479,1297880,3464,3297092,44479
Slovenia,2021-06-06,4606258,1300136,2256,3306122,9030,1300136,2256,3306122,9030
Slovenia,2021-06-07,4616050,1301465,1329,3314585,8463,1301465,1329,3314585,8463
Slovenia,2021-06-08,4660062,1304513,3048,3355549,40964,1304513,3048,3355549,40964
Slovenia,2021-06-09,4689101,1308019,3506,3381082,25533,1308019,3506,3381082,25533
Spain,2021-03-22,35523503,27047678,27047678,8475825,8475825,27047678,27047678,8475825,8475825
Spain,2021-03-23,35523503,27047678,0,8475825,0,27047678,0,8475825,0
Spain,2021-03-24,35523503,27047678,0,8475825,0,27047678,0,8475825,0
Spain,2021-03-25,35523503,27047678,0,8475825,0,27047678,0,8475825,0
Spain,2021-03-26,35523503,27047678,0,8475825,0,27047678,0,8475825,0
Spain,2021-03-27,35523503,27047678,0,8475825,0,27047678,0,8475825,0
Spain,2021-03-28,35523503,27047678,0,8475825,0,27047678,0,8475825,0
Spain,2021-03-29,36300583,27573864,526186,8726719,250894,27573864,526186,8726719,250894
Spain,2021-03-30,36300583,27573864,0,8726719,0,27573864,0,8726719,0
Spain,2021-03-31,36300583,27573864,0,8726719,0,27573864,0,8726719,0
Spain,2021-04-01,36300583,27573864,0,8726719,0,27573864,0,8726719,0
Spain,2021-04-02,36300583,27573864,0,8726719,0,27573864,0,8726719,0
Spain,2021-04-03,36300583,27573864,0,8726719,0,27573864,0,8726719,0
Spain,2021-04-04,36300583,27573864,0,8726719,0,27573864,0,8726719,0
Spain,2021-04-05,37012618,28028393,454529,8984225,257506,28028393,454529,8984225,257506
Spain,2021-04-06,37012618,28028393,0,8984225,0,28028393,0,8984225,0
Spain,2021-04-07,37012618,28028393,0,8984225,0,28028393,0,8984225,0
Spain,2021-04-08,37012618,28028393,0,8984225,0,28028393,0,8984225,0
Spain,2021-04-09,37012618,28028393,0,8984225,0,28028393,0,8984225,0
Spain,2021-04-10,37012618,28028393,0,8984225,0,28028393,0,8984225,0
Spain,2021-04-11,37012618,28028393,0,8984225,0,28028393,0,8984225,0
Spain,2021-04-12,37755947,28506257,477864,9249690,265465,28506257,477864,9249690,265465
Spain,2021-04-13,37755947,28506257,0,9249690,0,28506257,0,9249690,0
Spain,2021-04-14,37755947,28506257,0,9249690,0,28506257,0,9249690,0
Spain,2021-04-15,37755947,28506257,0,9249690,0,28506257,0,9249690,0
Spain,2021-04-16,37755947,28506257,0,9249690,0,28506257,0,9249690,0
Spain,2021-04-17,37755947,28506257,0,9249690,0,28506257,0,9249690,0
Spain,2021-04-18,37755947,28506257,0,9249690,0,28506257,0,9249690,0
Spain,2021-04-19,38644733,29087554,581297,9557179,307489,29087554,581297,9557179,307489
Spain,2021-04-20,38644733,29087554,0,9557179,0,29087554,0,9557179,0
Spain,2021-04-21,38644733,29087554,0,9557179,0,29087554,0,9557179,0
Spain,2021-04-22,38644733,29087554,0,9557179,0,29087554,0,9557179,0
Spain,2021-04-23,38644733,29087554,0,9557179,0,29087554,0,9557179,0
Spain,2021-04-24,38644733,29087554,0,9557179,0,29087554,0,9557179,0
Spain,2021-04-25,38644733,29087554,0,9557179,0,29087554,0,9557179,0
Spain,2021-04-26,39533769,29675676,588122,9858093,300914,29675676,588122,9858093,300914
Spain,2021-04-27,39533769,29675676,0,9858093,0,29675676,0,9858093,0
Spain,2021-04-28,39533769,29675676,0,9858093,0,29675676,0,9858093,0
Spain,2021-04-29,39533769,29675676,0,9858093,0,29675676,0,9858093,0
Spain,2021-04-30,39533769,29675676,0,9858093,0,29675676,0,9858093,0
Spain,2021-05-04,40462407,30277072,601396,10185335,327242,30277072,601396,10185335,327242
Spain,2021-05-05,40462407,30277072,0,10185335,0,30277072,0,10185335,0
Spain,2021-05-06,40462407,30277072,0,10185335,0,30277072,0,10185335,0
Spain,2021-05-07,40462407,30277072,0,10185335,0,30277072,0,10185335,0
Spain,2021-05-08,40462407,30277072,0,10185335,0,30277072,0,10185335,0
Spain,2021-05-09,40462407,30277072,0,10185335,0,30277072,0,10185335,0
Spain,2021-05-10,41297269,30836976,559904,10460293,274958,30836976,559904,10460293,274958
Spain,2021-05-11,41297269,30836976,0,10460293,0,30836976,0,10460293,0
Spain,2021-05-12,41297269,30836976,0,10460293,0,30836976,0,10460293,0
Spain,2021-05-13,41297269,30836976,0,10460293,0,30836976,0,10460293,0
Spain,2021-05-14,41297269,30836976,0,10460293,0,30836976,0,10460293,0
Spain,2021-05-15,41297269,30836976,0,10460293,0,30836976,0,10460293,0
Spain,2021-05-16,41297269,30836976,0,10460293,0,30836976,0,10460293,0
Spain,2021-05-17,42089670,31361349,524373,10728321,268028,31361349,524373,10728321,268028
Spain,2021-05-18,42089670,31361349,0,10728321,0,31361349,0,10728321,0
Spain,2021-05-19,42089670,31361349,0,10728321,0,31361349,0,10728321,0
Spain,2021-05-20,42089670,31361349,0,10728321,0,31361349,0,10728321,0
Spain,2021-05-21,42089670,31361349,0,10728321,0,31361349,0,10728321,0
Spain,2021-05-22,42089670,31361349,0,10728321,0,31361349,0,10728321,0
Spain,2021-05-23,42089670,31361349,0,10728321,0,31361349,0,10728321,0
Spain,2021-05-24,42846660,31853049,491700,10993611,265290,31853049,491700,10993611,265290
Spain,2021-05-25,42846660,31853049,0,10993611,0,31853049,0,10993611,0
Spain,2021-05-26,42846660,31853049,0,10993611,0,31853049,0,10993611,0
Spain,2021-05-27,42846660,31853049,0,10993611,0,31853049,0,10993611,0
Spain,2021-05-28,42846660,31853049,0,10993611,0,31853049,0,10993611,0
Spain,2021-05-29,42846660,31853049,0,10993611,0,31853049,0,10993611,0
Spain,2021-05-30,42846660,31853049,0,10993611,0,31853049,0,10993611,0
Spain,2021-05-31,43557867,32307229,454180,11250638,257027,32307229,454180,11250638,257027
Spain,2021-06-07,44294542,32784136,476907,11510406,259768,32784136,476907,11510406,259768
Spain,2021-06-08,44294542,32784136,0,11510406,0,32784136,0,11510406,0
Spain,2021-06-09,44294542,32784136,0,11510406,0,32784136,0,11510406,0
Spain,2021-06-10,44294542,32784136,0,11510406,0,32784136,0,11510406,0
Spain,2021-06-11,44294542,32784136,0,11510406,0,32784136,0,11510406,0
Spain,2021-06-12,44294542,32784136,0,11510406,0,32784136,0,11510406,0
Spain,2021-06-13,44294542,32784136,0,11510406,0,32784136,0,11510406,0
Spain,2021-06-14,44966212,33221873,437737,11744339,233933,33221873,437737,11744339,233933
Spain,2021-06-15,44966212,33221873,0,11744339,0,33221873,0,11744339,0
Spain,2021-06-16,44966212,33221873,0,11744339,0,33221873,0,11744339,0
Spain,2021-06-17,44966212,33221873,0,11744339,0,33221873,0,11744339,0
Spain,2021-06-18,44966212,33221873,0,11744339,0,33221873,0,11744339,0
Spain,2021-06-19,44966212,33221873,0,11744339,0,33221873,0,11744339,0
Spain,2021-06-20,44966212,33221873,0,11744339,0,33221873,0,11744339,0
Spain,2021-06-21,44966212,33221873,0,11744339,0,33221873,0,11744339,0
Spain,2021-06-22,44966212,33221873,0,11744339,0,33221873,0,11744339,0
Spain,2021-06-23,44966212,33221873,0,11744339,0,33221873,0,11744339,0
Spain,2021-06-24,44966212,33221873,0,11744339,0,33221873,0,11744339,0
Spain,2021-06-25,44966212,33221873,0,11744339,0,33221873,0,11744339,0
Spain,2021-06-26,44966212,33221873,0,11744339,0,33221873,0,11744339,0
Spain,2021-06-27,44966212,33221873,0,11744339,0,33221873,0,11744339,0
Spain,2021-06-28,46257190,34044503,822630,12212687,468348,34044503,822630,12212687,468348
Spain,2021-06-29,46257190,34044503,0,12212687,0,34044503,0,12212687,0
Spain,2021-06-30,46257190,34044503,0,12212687,0,34044503,0,12212687,0
Spain,2021-07-05,47038074,34520531,476028,12520531,307844,34520531,476028,12520531,307844
Spain,2021-07-06,47038074,34520531,0,12520531,0,34520531,0,12520531,0
Spain,2021-07-07,47038074,34520531,0,12520531,0,34520531,0,12520531,0
Spain,2021-07-08,47038074,34520531,0,12520531,0,34520531,0,12520531,0
Spain,2021-07-09,47038074,34520531,0,12520531,0,34520531,0,12520531,0
Switzerland,2021-03-22,5688784,4791598,4791598,897186,897186,4791598,4791598,897186,897186
Switzerland,2021-03-23,5720475,4808900,17302,911575,14389,4808900,17302,911575,14389
Switzerland,2021-03-24,5765946,4840971,32071,924975,13400,4840971,32071,924975,13400
Switzerland,2021-03-25,5808823,4870430,29459,938393,13418,4870430,29459,938393,13418
Switzerland,2021-03-26,5851917,4899229,28799,952688,14295,4899229,28799,952688,14295
Switzerland,2021-03-27,5851917,4899229,0,952688,0,4899229,0,952688,0
Switzerland,2021-03-28,5851917,4899229,0,952688,0,4899229,0,952688,0
Switzerland,2021-03-29,5942810,4958765,59536,984045,31357,4958765,59536,984045,31357
Switzerland,2021-03-30,5968525,4970013,11248,998512,14467,4970013,11248,998512,14467
Switzerland,2021-03-31,6012966,5001104,31091,1011862,13350,5001104,31091,1011862,13350
Switzerland,2021-04-01,6069595,5040722,39618,1028873,17011,5040722,39618,1028873,17011
Switzerland,2021-04-02,6126488,5077299,36577,1049189,20316,5077299,36577,1049189,20316
Switzerland,2021-04-03,6126488,5077299,0,1049189,0,5077299,0,1049189,0
Switzerland,2021-04-04,6126488,5077299,0,1049189,0,5077299,0,1049189,0
Switzerland,2021-04-05,6126488,5077299,0,1049189,0,5077299,0,1049189,0
Switzerland,2021-04-06,6226564,5139424,62125,1087140,37951,5139424,62125,1087140,37951
Switzerland,2021-04-07,6260306,5158523,19099,1101783,14643,5158523,19099,1101783,14643
Switzerland,2021-04-08,6300365,5186035,27512,1114330,12547,5186035,27512,1114330,12547
Switzerland,2021-04-09,6339396,5212732,26697,1126664,12334,5212732,26697,1126664,12334
Switzerland,2021-04-10,6339396,5212732,0,1126664,0,5212732,0,1126664,0
Switzerland,2021-04-11,6339396,5212732,0,1126664,0,5212732,0,1126664,0
Switzerland,2021-04-12,6412371,5264697,51965,1147674,21010,5264697,51965,1147674,21010
Switzerland,2021-04-13,6437818,5279756,15059,1158062,10388,5279756,15059,1158062,10388
Switzerland,2021-04-14,6474822,5307510,27754,1167312,9250,5307510,27754,1167312,9250
Switzerland,2021-04-15,6505841,5329794,22284,1176047,8735,5329794,22284,1176047,8735
Switzerland,2021-04-16,6538153,5353602,23808,1184551,8504,5353602,23808,1184551,8504
Switzerland,2021-04-17,6538153,5353602,0,1184551,0,5353602,0,1184551,0
Switzerland,2021-04-18,6538153,5353602,0,1184551,0,5353602,0,1184551,0
Switzerland,2021-04-19,6609958,5406498,52896,1203460,18909,5406498,52896,1203460,18909
Switzerland,2021-04-20,6633770,5420952,14454,1212818,9358,5420952,14454,1212818,9358
Switzerland,2021-04-21,6663629,5443440,22488,1220189,7371,5443440,22488,1220189,7371
Switzerland,2021-04-22,6692508,5464887,21447,1227621,7432,5464887,21447,1227621,7432
Switzerland,2021-04-23,6723694,5487857,22970,1235837,8216,5487857,22970,1235837,8216
Switzerland,2021-04-24,6723694,5487857,0,1235837,0,5487857,0,1235837,0
Switzerland,2021-04-25,6723694,5487857,0,1235837,0,5487857,0,1235837,0
Switzerland,2021-04-26,6794311,5540717,52860,1253594,17757,5540717,52860,1253594,17757
Switzerland,2021-04-27,6818583,5555757,15040,1262826,9232,5555757,15040,1262826,9232
Switzerland,2021-04-28,6848517,5578032,22275,1270485,7659,5578032,22275,1270485,7659
Switzerland,2021-04-29,6878392,5600472,22440,1277920,7435,5600472,22440,1277920,7435
Switzerland,2021-04-30,6911371,5625232,24760,1286139,8219,5625232,24760,1286139,8219
Switzerland,2021-05-01,6911371,5625232,0,1286139,0,5625232,0,1286139,0
Switzerland,2021-05-02,6911371,5625232,0,1286139,0,5625232,0,1286139,0
Switzerland,2021-05-03,6978583,5674650,49418,1303933,17794,5674650,49418,1303933,17794
Switzerland,2021-05-04,7001299,5688687,14037,1312612,8679,5688687,14037,1312612,8679
Switzerland,2021-05-05,7029684,5710443,21756,1319241,6629,5710443,21756,1319241,6629
Switzerland,2021-05-06,7057364,5731298,20855,1326066,6825,5731298,20855,1326066,6825
Switzerland,2021-05-07,7088449,5754515,23217,1333934,7868,5754515,23217,1333934,7868
Switzerland,2021-05-08,7088449,5754515,0,1333934,0,5754515,0,1333934,0
Switzerland,2021-05-09,7088449,5754515,0,1333934,0,5754515,0,1333934,0
Switzerland,2021-05-10,7154659,5803532,49017,1351127,17193,5803532,49017,1351127,17193
Switzerland,2021-05-11,7179360,5820019,16487,1359341,8214,5820019,16487,1359341,8214
Switzerland,2021-05-12,7216520,5848311,28292,1368209,8868,5848311,28292,1368209,8868
Switzerland,2021-05-13,7216520,5848311,0,1368209,0,5848311,0,1368209,0
Switzerland,2021-05-14,7273942,5891014,42703,1382928,14719,5891014,42703,1382928,14719
Switzerland,2021-05-15,7273942,5891014,0,1382928,0,5891014,0,1382928,0
Switzerland,2021-05-16,7273942,5891014,0,1382928,0,5891014,0,1382928,0
Switzerland,2021-05-17,7338506,5936767,45753,1401739,18811,5936767,45753,1401739,18811
Switzerland,2021-05-18,7360542,5950290,13523,1410252,8513,5950290,13523,1410252,8513
Switzerland,2021-05-19,7390415,5972923,22633,1417492,7240,5972923,22633,1417492,7240
Switzerland,2021-05-20,7421613,5995772,22849,1425841,8349,5995772,22849,1425841,8349
Switzerland,2021-05-21,7460843,6022549,26777,1438294,12453,6022549,26777,1438294,12453
Switzerland,2021-05-22,7460843,6022549,0,1438294,0,6022549,0,1438294,0
Switzerland,2021-05-23,7460843,6022549,0,1438294,0,6022549,0,1438294,0
Switzerland,2021-05-24,7460843,6022549,0,1438294,0,6022549,0,1438294,0
Switzerland,2021-05-25,7549270,6080470,57921,1468800,30506,6080470,57921,1468800,30506
Switzerland,2021-05-26,7571745,6095013,14543,1476732,7932,6095013,14543,1476732,7932
Switzerland,2021-05-27,7600865,6117070,22057,1483795,7063,6117070,22057,1483795,7063
Switzerland,2021-05-28,7630534,6138289,21219,1492245,8450,6138289,21219,1492245,8450
Switzerland,2021-05-29,7630534,6138289,0,1492245,0,6138289,0,1492245,0
Switzerland,2021-05-30,7630534,6138289,0,1492245,0,6138289,0,1492245,0
Switzerland,2021-05-31,7692747,6182011,43722,1510736,18491,6182011,43722,1510736,18491
Switzerland,2021-06-01,7713814,6195414,13403,1518400,7664,6195414,13403,1518400,7664
Switzerland,2021-06-02,7741923,6215287,19873,1526636,8236,6215287,19873,1526636,8236
Switzerland,2021-06-03,7773369,6236224,20937,1537145,10509,6236224,20937,1537145,10509
Switzerland,2021-06-04,7799402,6255357,19133,1544045,6900,6255357,19133,1544045,6900
Switzerland,2021-06-05,7799402,6255357,0,1544045,0,6255357,0,1544045,0
Switzerland,2021-06-06,7799402,6255357,0,1544045,0,6255357,0,1544045,0
Switzerland,2021-06-07,7857449,6294516,39159,1562933,18888,6294516,39159,1562933,18888
Switzerland,2021-06-08,7875323,6305261,10745,1570062,7129,6305261,10745,1570062,7129
Switzerland,2021-06-09,7897523,6321621,16360,1575902,5840,6321621,16360,1575902,5840
Switzerland,2021-06-10,7919475,6336863,15242,1582612,6710,6336863,15242,1582612,6710
Switzerland,2021-06-11,7945174,6353571,16708,1591603,8991,6353571,16708,1591603,8991
Switzerland,2021-06-12,7945174,6353571,0,1591603,0,6353571,0,1591603,0
Switzerland,2021-06-13,7945174,6353571,0,1591603,0,6353571,0,1591603,0
Switzerland,2021-06-14,7999355,6386579,33008,1612776,21173,6386579,33008,1612776,21173
Switzerland,2021-06-15,8017244,6396700,10121,1620544,7768,6396700,10121,1620544,7768
Switzerland,2021-06-16,8037136,6409590,12890,1627546,7002,6409590,12890,1627546,7002
Switzerland,2021-06-17,8058247,6423228,13638,1635019,7473,6423228,13638,1635019,7473
Switzerland,2021-06-18,8084820,6439056,15828,1645764,10745,6439056,15828,1645764,10745
Switzerland,2021-06-19,8084820,6439056,0,1645764,0,6439056,0,1645764,0
Switzerland,2021-06-20,8084820,6439056,0,1645764,0,6439056,0,1645764,0
Switzerland,2021-06-21,8140729,6468935,29879,1671794,26030,6468935,29879,1671794,26030
Switzerland,2021-06-22,8157861,6477420,8485,1680441,8647,6477420,8485,1680441,8647
Switzerland,2021-06-23,8176521,6488832,11412,1687689,7248,6488832,11412,1687689,7248
Switzerland,2021-06-24,8196899,6501185,12353,1695714,8025,6501185,12353,1695714,8025
Switzerland,2021-06-25,8221551,6514700,13515,1706851,11137,6514700,13515,1706851,11137
Switzerland,2021-06-26,8221551,6514700,0,1706851,0,6514700,0,1706851,0
Switzerland,2021-06-27,8221551,6514700,0,1706851,0,6514700,0,1706851,0
Switzerland,2021-06-28,8273152,6540466,25766,1732686,25835,6540466,25766,1732686,25835
Switzerland,2021-06-29,8289363,6548042,7576,1741321,8635,6548042,7576,1741321,8635
Switzerland,2021-06-30,8306968,6559180,11138,1747788,6467,6559180,11138,1747788,6467
Switzerland,2021-07-01,8329750,6571764,12584,1757986,10198,6571764,12584,1757986,10198
Switzerland,2021-07-02,8359875,6586554,14790,1773321,15335,6586554,14790,1773321,15335
Switzerland,2021-07-03,8359875,6586554,0,1773321,0,6586554,0,1773321,0
Switzerland,2021-07-04,8359875,6586554,0,1773321,0,6586554,0,1773321,0
Switzerland,2021-07-05,8437613,6618543,31989,1819070,45749,6618543,31989,1819070,45749
Switzerland,2021-07-06,8459588,6628833,10290,1830755,11685,6628833,10290,1830755,11685
Switzerland,2021-07-07,8482848,6640263,11430,1842585,11830,6640263,11430,1842585,11830
Switzerland,2021-07-08,8506560,6652049,11786,1854511,11926,6652049,11786,1854511,11926
Switzerland,2021-07-09,8540340,6667474,15425,1872866,18355,6667474,15425,1872866,18355
