country,date,tests_cumulative,new_tests,tests_cumulative_corrected,new_tests_corrected,source
Thailand,2020-03-10,47903,611,47903,611,http://nextcloud.dmsc.moph.go.th/index.php/s/wbioWZAQfManokc
Thailand,2020-03-11,48908,1005,48908,1005,http://nextcloud.dmsc.moph.go.th/index.php/s/wbioWZAQfManokc
Thailand,2020-03-12,49962,1054,49962,1054,http://nextcloud.dmsc.moph.go.th/index.php/s/wbioWZAQfManokc
Thailand,2020-03-13,51208,1246,51208,1246,http://nextcloud.dmsc.moph.go.th/index.php/s/wbioWZAQfManokc
Thailand,2020-03-14,52564,1356,52564,1356,http://nextcloud.dmsc.moph.go.th/index.php/s/wbioWZAQfManokc
Thailand,2020-03-15,54670,2106,54670,2106,http://nextcloud.dmsc.moph.go.th/index.php/s/wbioWZAQfManokc
Thailand,2020-03-16,56860,2190,56860,2190,http://nextcloud.dmsc.moph.go.th/index.php/s/wbioWZAQfManokc
Thailand,2020-03-17,60022,3162,60022,3162,http://nextcloud.dmsc.moph.go.th/index.php/s/wbioWZAQfManokc
Thailand,2020-03-18,62718,2696,62718,2696,http://nextcloud.dmsc.moph.go.th/index.php/s/wbioWZAQfManokc
Thailand,2020-03-19,65613,2895,65613,2895,http://nextcloud.dmsc.moph.go.th/index.php/s/wbioWZAQfManokc
Thailand,2020-03-20,67722,2109,67722,2109,http://nextcloud.dmsc.moph.go.th/index.php/s/wbioWZAQfManokc
Thailand,2020-03-21,69390,1668,69390,1668,http://nextcloud.dmsc.moph.go.th/index.php/s/wbioWZAQfManokc
Thailand,2020-03-22,71448,2058,71448,2058,http://nextcloud.dmsc.moph.go.th/index.php/s/wbioWZAQfManokc
Thailand,2020-03-23,73817,2369,73817,2369,http://nextcloud.dmsc.moph.go.th/index.php/s/wbioWZAQfManokc
Thailand,2020-03-24,76180,2363,76180,2363,http://nextcloud.dmsc.moph.go.th/index.php/s/wbioWZAQfManokc
Thailand,2020-03-25,79103,2923,79103,2923,http://nextcloud.dmsc.moph.go.th/index.php/s/wbioWZAQfManokc
Thailand,2020-03-26,82461,3358,82461,3358,http://nextcloud.dmsc.moph.go.th/index.php/s/wbioWZAQfManokc
Thailand,2020-03-27,85890,3429,85890,3429,http://nextcloud.dmsc.moph.go.th/index.php/s/wbioWZAQfManokc
Thailand,2020-03-28,88517,2627,88517,2627,http://nextcloud.dmsc.moph.go.th/index.php/s/wbioWZAQfManokc
Thailand,2020-03-29,90768,2251,90768,2251,http://nextcloud.dmsc.moph.go.th/index.php/s/wbioWZAQfManokc
Thailand,2020-03-30,93088,2320,93088,2320,http://nextcloud.dmsc.moph.go.th/index.php/s/wbioWZAQfManokc
Thailand,2020-03-31,95594,2506,95594,2506,http://nextcloud.dmsc.moph.go.th/index.php/s/wbioWZAQfManokc
Thailand,2020-04-01,98371,2777,98371,2777,http://nextcloud.dmsc.moph.go.th/index.php/s/wbioWZAQfManokc
Thailand,2020-04-02,101334,2963,101334,2963,http://nextcloud.dmsc.moph.go.th/index.php/s/wbioWZAQfManokc
Thailand,2020-04-03,104096,2762,104096,2762,http://nextcloud.dmsc.moph.go.th/index.php/s/wbioWZAQfManokc
Thailand,2020-04-04,107285,3189,107285,3189,http://nextcloud.dmsc.moph.go.th/index.php/s/wbioWZAQfManokc
Thailand,2020-04-05,110810,3525,110810,3525,http://nextcloud.dmsc.moph.go.th/index.php/s/wbioWZAQfManokc
Thailand,2020-04-06,114701,3891,114701,3891,http://nextcloud.dmsc.moph.go.th/index.php/s/wbioWZAQfManokc
Thailand,2020-04-07,119439,4738,119439,4738,http://nextcloud.dmsc.moph.go.th/index.php/s/wbioWZAQfManokc
Thailand,2020-04-08,123243,3804,123243,3804,http://nextcloud.dmsc.moph.go.th/index.php/s/wbioWZAQfManokc
Thailand,2020-04-09,126820,3577,126820,3577,http://nextcloud.dmsc.moph.go.th/index.php/s/wbioWZAQfManokc
Thailand,2020-04-10,130596,3776,130596,3776,http://nextcloud.dmsc.moph.go.th/index.php/s/wbioWZAQfManokc
Thailand,2020-04-11,134488,3892,134488,3892,http://nextcloud.dmsc.moph.go.th/index.php/s/wbioWZAQfManokc
Thailand,2020-04-12,137242,2754,137242,2754,http://nextcloud.dmsc.moph.go.th/index.php/s/wbioWZAQfManokc
Thailand,2020-04-13,140940,3698,140940,3698,http://nextcloud.dmsc.moph.go.th/index.php/s/wbioWZAQfManokc
Thailand,2020-04-14,144844,3904,144844,3904,http://nextcloud.dmsc.moph.go.th/index.php/s/wbioWZAQfManokc
Thailand,2020-04-15,149723,4879,149723,4879,http://nextcloud.dmsc.moph.go.th/index.php/s/wbioWZAQfManokc
Thailand,2020-04-16,155142,5419,155142,5419,http://nextcloud.dmsc.moph.go.th/index.php/s/wbioWZAQfManokc
Thailand,2020-04-17,160034,4892,160034,4892,http://nextcloud.dmsc.moph.go.th/index.php/s/wbioWZAQfManokc
Thailand,2020-04-18,166210,6176,166210,6176,http://nextcloud.dmsc.moph.go.th/index.php/s/wbioWZAQfManokc
Thailand,2020-04-19,170676,4466,170676,4466,http://nextcloud.dmsc.moph.go.th/index.php/s/wbioWZAQfManokc
Thailand,2020-04-20,174900,4224,174900,4224,http://nextcloud.dmsc.moph.go.th/index.php/s/wbioWZAQfManokc
Thailand,2020-04-21,180417,5517,180417,5517,http://nextcloud.dmsc.moph.go.th/index.php/s/wbioWZAQfManokc
Thailand,2020-04-22,187350,6933,187350,6933,http://nextcloud.dmsc.moph.go.th/index.php/s/wbioWZAQfManokc
Thailand,2020-04-23,196572,9222,196572,9222,http://nextcloud.dmsc.moph.go.th/index.php/s/wbioWZAQfManokc
Thailand,2020-04-24,203099,6527,203099,6527,http://nextcloud.dmsc.moph.go.th/index.php/s/wbioWZAQfManokc
Thailand,2020-04-25,208718,5619,208718,5619,http://nextcloud.dmsc.moph.go.th/index.php/s/wbioWZAQfManokc
Thailand,2020-04-26,214554,5836,214554,5836,http://nextcloud.dmsc.moph.go.th/index.php/s/wbioWZAQfManokc
Thailand,2020-04-27,222626,8072,222626,8072,http://nextcloud.dmsc.moph.go.th/index.php/s/wbioWZAQfManokc
Thailand,2020-04-28,232391,9765,232391,9765,http://nextcloud.dmsc.moph.go.th/index.php/s/wbioWZAQfManokc
Thailand,2020-04-29,241163,8772,241163,8772,http://nextcloud.dmsc.moph.go.th/index.php/s/wbioWZAQfManokc
Thailand,2020-04-30,252586,11423,252586,11423,http://nextcloud.dmsc.moph.go.th/index.php/s/wbioWZAQfManokc
Thailand,2020-05-01,260116,7530,260116,7530,http://nextcloud.dmsc.moph.go.th/index.php/s/wbioWZAQfManokc
Thailand,2020-05-02,269359,9243,269359,9243,http://nextcloud.dmsc.moph.go.th/index.php/s/wbioWZAQfManokc
Thailand,2020-05-03,275444,6085,275444,6085,http://nextcloud.dmsc.moph.go.th/index.php/s/wbioWZAQfManokc
Thailand,2020-05-04,281955,6511,281955,6511,http://nextcloud.dmsc.moph.go.th/index.php/s/wbioWZAQfManokc
Thailand,2020-05-05,289281,7326,289281,7326,http://nextcloud.dmsc.moph.go.th/index.php/s/wbioWZAQfManokc
Thailand,2020-05-06,295472,6191,295472,6191,http://nextcloud.dmsc.moph.go.th/index.php/s/wbioWZAQfManokc
Thailand,2020-05-07,303139,7667,303139,7667,http://nextcloud.dmsc.moph.go.th/index.php/s/wbioWZAQfManokc
Thailand,2020-05-08,311055,7916,311055,7916,http://nextcloud.dmsc.moph.go.th/index.php/s/wbioWZAQfManokc
Thailand,2020-05-09,317249,6194,317249,6194,http://nextcloud.dmsc.moph.go.th/index.php/s/wbioWZAQfManokc
Thailand,2020-05-10,322825,5576,322825,5576,http://nextcloud.dmsc.moph.go.th/index.php/s/wbioWZAQfManokc
Thailand,2020-05-11,328584,5759,328584,5759,http://nextcloud.dmsc.moph.go.th/index.php/s/wbioWZAQfManokc
Thailand,2020-05-12,335369,6785,335369,6785,http://nextcloud.dmsc.moph.go.th/index.php/s/wbioWZAQfManokc
Thailand,2020-05-13,342809,7440,342809,7440,http://nextcloud.dmsc.moph.go.th/index.php/s/wbioWZAQfManokc
Thailand,2020-05-14,349819,7010,349819,7010,http://nextcloud.dmsc.moph.go.th/index.php/s/wbioWZAQfManokc
Thailand,2020-05-15,357894,8075,357894,8075,http://nextcloud.dmsc.moph.go.th/index.php/s/wbioWZAQfManokc
Thailand,2020-05-16,364385,6491,364385,6491,http://nextcloud.dmsc.moph.go.th/index.php/s/wbioWZAQfManokc
Thailand,2020-05-17,368428,4043,368428,4043,http://nextcloud.dmsc.moph.go.th/index.php/s/wbioWZAQfManokc
Thailand,2020-05-18,375189,6761,375189,6761,http://nextcloud.dmsc.moph.go.th/index.php/s/wbioWZAQfManokc
Thailand,2020-05-19,382845,7656,382845,7656,http://nextcloud.dmsc.moph.go.th/index.php/s/wbioWZAQfManokc
Thailand,2020-05-20,391379,8534,391379,8534,http://nextcloud.dmsc.moph.go.th/index.php/s/wbioWZAQfManokc
Thailand,2020-05-21,400006,8627,400006,8627,http://nextcloud.dmsc.moph.go.th/index.php/s/wbioWZAQfManokc
Thailand,2020-05-22,407742,7736,407742,7736,http://nextcloud.dmsc.moph.go.th/index.php/s/wbioWZAQfManokc
Thailand,2020-05-23,415656,7914,415656,7914,http://nextcloud.dmsc.moph.go.th/index.php/s/wbioWZAQfManokc
Thailand,2020-05-24,419954,4298,419954,4298,http://nextcloud.dmsc.moph.go.th/index.php/s/wbioWZAQfManokc
Thailand,2020-05-25,428148,8194,428148,8194,http://nextcloud.dmsc.moph.go.th/index.php/s/wbioWZAQfManokc
Thailand,2020-05-26,437341,9193,437341,9193,http://nextcloud.dmsc.moph.go.th/index.php/s/wbioWZAQfManokc
Thailand,2020-05-27,447362,10021,447362,10021,http://nextcloud.dmsc.moph.go.th/index.php/s/wbioWZAQfManokc
Thailand,2020-05-28,456543,9181,456543,9181,http://nextcloud.dmsc.moph.go.th/index.php/s/wbioWZAQfManokc
Thailand,2020-05-29,465302,8759,465302,8759,http://nextcloud.dmsc.moph.go.th/index.php/s/wbioWZAQfManokc
Thailand,2020-05-30,473060,7758,473060,7758,http://nextcloud.dmsc.moph.go.th/index.php/s/wbioWZAQfManokc
Thailand,2020-05-31,477857,4797,477857,4797,http://nextcloud.dmsc.moph.go.th/index.php/s/wbioWZAQfManokc
Thailand,2020-06-01,485960,8103,485960,8103,http://nextcloud.dmsc.moph.go.th/index.php/s/wbioWZAQfManokc
Thailand,2020-06-02,496253,10293,496253,10293,http://nextcloud.dmsc.moph.go.th/index.php/s/wbioWZAQfManokc
Thailand,2020-06-03,502949,6696,502949,6696,http://nextcloud.dmsc.moph.go.th/index.php/s/wbioWZAQfManokc
Thailand,2020-06-04,512978,10029,512978,10029,http://nextcloud.dmsc.moph.go.th/index.php/s/wbioWZAQfManokc
Thailand,2020-06-05,521941,8963,521941,8963,http://nextcloud.dmsc.moph.go.th/index.php/s/wbioWZAQfManokc
Thailand,2020-06-06,527200,5259,527200,5259,http://nextcloud.dmsc.moph.go.th/index.php/s/wbioWZAQfManokc
Thailand,2020-06-07,532281,5081,532281,5081,http://nextcloud.dmsc.moph.go.th/index.php/s/wbioWZAQfManokc
Thailand,2020-06-08,540951,8670,540951,8670,http://nextcloud.dmsc.moph.go.th/index.php/s/wbioWZAQfManokc
Thailand,2020-06-09,551477,10526,551477,10526,http://nextcloud.dmsc.moph.go.th/index.php/s/wbioWZAQfManokc
Thailand,2020-06-10,559417,7940,559417,7940,http://nextcloud.dmsc.moph.go.th/index.php/s/wbioWZAQfManokc
Thailand,2020-06-11,569783,10366,569783,10366,http://nextcloud.dmsc.moph.go.th/index.php/s/wbioWZAQfManokc
Thailand,2020-06-12,578601,8818,578601,8818,http://nextcloud.dmsc.moph.go.th/index.php/s/wbioWZAQfManokc
Thailand,2020-06-13,584227,5626,584227,5626,http://nextcloud.dmsc.moph.go.th/index.php/s/wbioWZAQfManokc
Thailand,2020-06-14,589025,4798,589025,4798,http://nextcloud.dmsc.moph.go.th/index.php/s/wbioWZAQfManokc
Thailand,2020-06-15,596988,7963,596988,7963,http://nextcloud.dmsc.moph.go.th/index.php/s/wbioWZAQfManokc
Thailand,2020-06-16,605924,8936,605924,8936,http://nextcloud.dmsc.moph.go.th/index.php/s/wbioWZAQfManokc
Thailand,2020-06-17,613926,8002,613926,8002,http://nextcloud.dmsc.moph.go.th/index.php/s/wbioWZAQfManokc
Thailand,2020-06-18,622063,8137,622063,8137,http://nextcloud.dmsc.moph.go.th/index.php/s/wbioWZAQfManokc
Thailand,2020-06-19,628954,6891,628954,6891,http://nextcloud.dmsc.moph.go.th/index.php/s/wbioWZAQfManokc
Thailand,2020-06-20,632897,3943,632897,3943,http://nextcloud.dmsc.moph.go.th/index.php/s/wbioWZAQfManokc
Thailand,2020-06-21,636502,3605,636502,3605,http://nextcloud.dmsc.moph.go.th/index.php/s/wbioWZAQfManokc
Thailand,2020-06-22,642707,6205,642707,6205,http://nextcloud.dmsc.moph.go.th/index.php/s/wbioWZAQfManokc
Thailand,2020-06-23,648486,5779,648486,5779,http://nextcloud.dmsc.moph.go.th/index.php/s/wbioWZAQfManokc
Thailand,2020-06-24,653749,5263,653749,5263,http://nextcloud.dmsc.moph.go.th/index.php/s/wbioWZAQfManokc
Thailand,2020-06-25,660420,6671,660420,6671,http://nextcloud.dmsc.moph.go.th/index.php/s/wbioWZAQfManokc
Thailand,2020-06-26,664740,4320,664740,4320,http://nextcloud.dmsc.moph.go.th/index.php/s/wbioWZAQfManokc
Thailand,2020-06-27,668283,3543,668283,3543,http://nextcloud.dmsc.moph.go.th/index.php/s/wbioWZAQfManokc
Thailand,2020-06-28,670830,2547,670830,2547,http://nextcloud.dmsc.moph.go.th/index.php/s/wbioWZAQfManokc
Thailand,2020-06-29,677267,6437,677267,6437,http://nextcloud.dmsc.moph.go.th/index.php/s/wbioWZAQfManokc
Thailand,2020-06-30,682526,5259,682526,5259,http://nextcloud.dmsc.moph.go.th/index.php/s/wbioWZAQfManokc
Thailand,2020-07-01,686906,4380,686906,4380,http://nextcloud.dmsc.moph.go.th/index.php/s/wbioWZAQfManokc
Thailand,2020-07-02,691551,4645,691551,4645,http://nextcloud.dmsc.moph.go.th/index.php/s/wbioWZAQfManokc
Thailand,2020-07-03,695806,4255,695806,4255,http://nextcloud.dmsc.moph.go.th/index.php/s/wbioWZAQfManokc
Thailand,2020-07-04,698212,2406,698212,2406,http://nextcloud.dmsc.moph.go.th/index.php/s/wbioWZAQfManokc
Thailand,2020-07-05,700741,2529,700741,2529,http://nextcloud.dmsc.moph.go.th/index.php/s/wbioWZAQfManokc
Thailand,2020-07-06,703855,3114,703855,3114,http://nextcloud.dmsc.moph.go.th/index.php/s/wbioWZAQfManokc
Thailand,2020-07-07,706855,3000,706855,3000,http://nextcloud.dmsc.moph.go.th/index.php/s/wbioWZAQfManokc
Thailand,2020-07-08,710370,3515,710370,3515,http://nextcloud.dmsc.moph.go.th/index.php/s/wbioWZAQfManokc
Thailand,2020-07-09,714705,4335,714705,4335,http://nextcloud.dmsc.moph.go.th/index.php/s/wbioWZAQfManokc
Thailand,2020-07-10,719781,5076,719781,5076,http://nextcloud.dmsc.moph.go.th/index.php/s/wbioWZAQfManokc
Thailand,2020-07-11,723098,3317,723098,3317,http://nextcloud.dmsc.moph.go.th/index.php/s/wbioWZAQfManokc
Thailand,2020-07-12,725911,2813,725911,2813,http://nextcloud.dmsc.moph.go.th/index.php/s/wbioWZAQfManokc
Thailand,2020-07-13,730032,4121,730032,4121,http://nextcloud.dmsc.moph.go.th/index.php/s/wbioWZAQfManokc
Thailand,2020-07-14,736159,6127,736159,6127,http://nextcloud.dmsc.moph.go.th/index.php/s/wbioWZAQfManokc
Thailand,2020-07-15,741546,5387,741546,5387,http://nextcloud.dmsc.moph.go.th/index.php/s/wbioWZAQfManokc
Thailand,2020-07-16,749901,8355,749901,8355,http://nextcloud.dmsc.moph.go.th/index.php/s/wbioWZAQfManokc
Thailand,2020-07-17,755929,6028,755929,6028,http://nextcloud.dmsc.moph.go.th/index.php/s/wbioWZAQfManokc
Thailand,2020-07-18,760810,4881,760810,4881,http://nextcloud.dmsc.moph.go.th/index.php/s/wbioWZAQfManokc
Thailand,2020-07-19,764130,3320,764130,3320,http://nextcloud.dmsc.moph.go.th/index.php/s/wbioWZAQfManokc
Thailand,2020-07-20,768860,4730,768860,4730,http://nextcloud.dmsc.moph.go.th/index.php/s/wbioWZAQfManokc
Thailand,2020-07-21,773333,4473,773333,4473,http://nextcloud.dmsc.moph.go.th/index.php/s/wbioWZAQfManokc
Thailand,2020-07-22,779988,6655,779988,6655,http://nextcloud.dmsc.moph.go.th/index.php/s/wbioWZAQfManokc
Thailand,2020-07-23,785766,5778,785766,5778,http://nextcloud.dmsc.moph.go.th/index.php/s/wbioWZAQfManokc
Thailand,2020-07-24,791538,5772,791538,5772,http://nextcloud.dmsc.moph.go.th/index.php/s/wbioWZAQfManokc
Thailand,2020-07-25,795435,3897,795435,3897,http://nextcloud.dmsc.moph.go.th/index.php/s/wbioWZAQfManokc
Thailand,2020-07-26,798397,2962,798397,2962,http://nextcloud.dmsc.moph.go.th/index.php/s/wbioWZAQfManokc
Thailand,2020-07-27,802723,4326,802723,4326,http://nextcloud.dmsc.moph.go.th/index.php/s/wbioWZAQfManokc
Thailand,2020-07-28,807347,4624,807347,4624,http://nextcloud.dmsc.moph.go.th/index.php/s/wbioWZAQfManokc
Thailand,2020-07-29,813005,5658,813005,5658,http://nextcloud.dmsc.moph.go.th/index.php/s/wbioWZAQfManokc
Thailand,2020-07-30,819920,6915,819920,6915,http://nextcloud.dmsc.moph.go.th/index.php/s/wbioWZAQfManokc
Thailand,2020-07-31,824949,5029,824949,5029,http://nextcloud.dmsc.moph.go.th/index.php/s/wbioWZAQfManokc
Thailand,2020-08-01,828630,3681,828630,3681,http://nextcloud.dmsc.moph.go.th/index.php/s/wbioWZAQfManokc
Thailand,2020-08-02,831816,3186,831816,3186,http://nextcloud.dmsc.moph.go.th/index.php/s/wbioWZAQfManokc
Thailand,2020-08-03,835517,3701,835517,3701,http://nextcloud.dmsc.moph.go.th/index.php/s/wbioWZAQfManokc
Thailand,2020-08-04,839472,3955,839472,3955,http://nextcloud.dmsc.moph.go.th/index.php/s/wbioWZAQfManokc
Thailand,2020-08-05,844066,4594,844066,4594,http://nextcloud.dmsc.moph.go.th/index.php/s/wbioWZAQfManokc
Thailand,2020-08-06,848052,3986,848052,3986,http://nextcloud.dmsc.moph.go.th/index.php/s/wbioWZAQfManokc
Thailand,2020-08-07,852585,4533,852585,4533,http://nextcloud.dmsc.moph.go.th/index.php/s/wbioWZAQfManokc
Thailand,2020-08-08,856964,4379,856964,4379,http://nextcloud.dmsc.moph.go.th/index.php/s/wbioWZAQfManokc
Thailand,2020-08-09,860516,3552,860516,3552,http://nextcloud.dmsc.moph.go.th/index.php/s/wbioWZAQfManokc
Thailand,2020-08-10,864072,3556,864072,3556,http://nextcloud.dmsc.moph.go.th/index.php/s/wbioWZAQfManokc
Thailand,2020-08-11,868208,4136,868208,4136,http://nextcloud.dmsc.moph.go.th/index.php/s/wbioWZAQfManokc
Thailand,2020-08-12,872211,4003,872211,4003,http://nextcloud.dmsc.moph.go.th/index.php/s/wbioWZAQfManokc
Thailand,2020-08-13,876245,4034,876245,4034,http://nextcloud.dmsc.moph.go.th/index.php/s/wbioWZAQfManokc
Thailand,2020-08-14,879489,3244,879489,3244,http://nextcloud.dmsc.moph.go.th/index.php/s/wbioWZAQfManokc
Thailand,2020-08-15,882845,3356,882845,3356,http://nextcloud.dmsc.moph.go.th/index.php/s/wbioWZAQfManokc
Thailand,2020-08-16,885917,3072,885917,3072,http://nextcloud.dmsc.moph.go.th/index.php/s/wbioWZAQfManokc
Thailand,2020-08-17,890179,4262,890179,4262,http://nextcloud.dmsc.moph.go.th/index.php/s/wbioWZAQfManokc
Thailand,2020-08-18,894379,4200,894379,4200,http://nextcloud.dmsc.moph.go.th/index.php/s/wbioWZAQfManokc
Thailand,2020-08-19,900587,6208,900587,6208,http://nextcloud.dmsc.moph.go.th/index.php/s/wbioWZAQfManokc
Thailand,2020-08-20,906060,5473,906060,5473,http://nextcloud.dmsc.moph.go.th/index.php/s/wbioWZAQfManokc
Thailand,2020-08-21,910357,4297,910357,4297,http://nextcloud.dmsc.moph.go.th/index.php/s/wbioWZAQfManokc
Thailand,2020-08-22,913925,3568,913925,3568,http://nextcloud.dmsc.moph.go.th/index.php/s/wbioWZAQfManokc
Thailand,2020-08-23,916591,2666,916591,2666,http://nextcloud.dmsc.moph.go.th/index.php/s/wbioWZAQfManokc
Thailand,2020-08-24,921938,5347,921938,5347,http://nextcloud.dmsc.moph.go.th/index.php/s/wbioWZAQfManokc
Thailand,2020-08-25,925626,3688,925626,3688,http://nextcloud.dmsc.moph.go.th/index.php/s/wbioWZAQfManokc
Thailand,2020-08-26,930835,5209,930835,5209,http://nextcloud.dmsc.moph.go.th/index.php/s/wbioWZAQfManokc
Thailand,2020-08-27,935701,4866,935701,4866,http://nextcloud.dmsc.moph.go.th/index.php/s/wbioWZAQfManokc
Thailand,2020-08-28,940456,4755,940456,4755,http://nextcloud.dmsc.moph.go.th/index.php/s/wbioWZAQfManokc
Thailand,2020-08-29,944019,3563,944019,3563,http://nextcloud.dmsc.moph.go.th/index.php/s/wbioWZAQfManokc
Thailand,2020-08-30,947703,3684,947703,3684,http://nextcloud.dmsc.moph.go.th/index.php/s/wbioWZAQfManokc
Thailand,2020-08-31,952691,4988,952691,4988,http://nextcloud.dmsc.moph.go.th/index.php/s/wbioWZAQfManokc
Thailand,2020-09-01,956911,4220,956911,4220,http://nextcloud.dmsc.moph.go.th/index.php/s/wbioWZAQfManokc
Thailand,2020-09-02,960732,3821,960732,3821,http://nextcloud.dmsc.moph.go.th/index.php/s/wbioWZAQfManokc
Thailand,2020-09-03,965421,4689,965421,4689,http://nextcloud.dmsc.moph.go.th/index.php/s/wbioWZAQfManokc
Thailand,2020-09-04,969983,4562,969983,4562,http://nextcloud.dmsc.moph.go.th/index.php/s/wbioWZAQfManokc
Thailand,2020-09-05,972886,2903,972886,2903,http://nextcloud.dmsc.moph.go.th/index.php/s/wbioWZAQfManokc
Thailand,2020-09-06,976349,3463,976349,3463,http://nextcloud.dmsc.moph.go.th/index.php/s/wbioWZAQfManokc
Thailand,2020-09-07,981086,4737,981086,4737,http://nextcloud.dmsc.moph.go.th/index.php/s/wbioWZAQfManokc
Thailand,2020-09-08,987261,6175,987261,6175,http://nextcloud.dmsc.moph.go.th/index.php/s/wbioWZAQfManokc
Thailand,2020-09-09,992629,5368,992629,5368,http://nextcloud.dmsc.moph.go.th/index.php/s/wbioWZAQfManokc
Thailand,2020-09-10,997616,4987,997616,4987,http://nextcloud.dmsc.moph.go.th/index.php/s/wbioWZAQfManokc
Thailand,2020-09-11,1002626,5010,1002626,5010,http://nextcloud.dmsc.moph.go.th/index.php/s/wbioWZAQfManokc
Thailand,2020-09-12,1007634,5008,1007634,5008,http://nextcloud.dmsc.moph.go.th/index.php/s/wbioWZAQfManokc
Thailand,2020-09-13,1010619,2985,1010619,2985,http://nextcloud.dmsc.moph.go.th/index.php/s/wbioWZAQfManokc
Thailand,2020-09-14,1015008,4389,1015008,4389,http://nextcloud.dmsc.moph.go.th/index.php/s/wbioWZAQfManokc
Thailand,2020-09-15,1019108,4100,1019108,4100,http://nextcloud.dmsc.moph.go.th/index.php/s/wbioWZAQfManokc
Thailand,2020-09-16,1023343,4235,1023343,4235,http://nextcloud.dmsc.moph.go.th/index.php/s/wbioWZAQfManokc
Thailand,2020-09-17,1027378,4035,1027378,4035,http://nextcloud.dmsc.moph.go.th/index.php/s/wbioWZAQfManokc
Thailand,2020-09-18,1031746,4368,1031746,4368,http://nextcloud.dmsc.moph.go.th/index.php/s/wbioWZAQfManokc
Thailand,2020-09-19,1034750,3004,1034750,3004,http://nextcloud.dmsc.moph.go.th/index.php/s/wbioWZAQfManokc
Thailand,2020-09-20,1037887,3137,1037887,3137,http://nextcloud.dmsc.moph.go.th/index.php/s/wbioWZAQfManokc
Thailand,2020-09-21,1043095,5208,1043095,5208,http://nextcloud.dmsc.moph.go.th/index.php/s/wbioWZAQfManokc
Thailand,2020-09-22,1048615,5520,1048615,5520,http://nextcloud.dmsc.moph.go.th/index.php/s/wbioWZAQfManokc
Thailand,2020-09-23,1053216,4601,1053216,4601,http://nextcloud.dmsc.moph.go.th/index.php/s/wbioWZAQfManokc
Thailand,2020-09-24,1057895,4679,1057895,4679,http://nextcloud.dmsc.moph.go.th/index.php/s/wbioWZAQfManokc
Thailand,2020-09-25,1062385,4490,1062385,4490,http://nextcloud.dmsc.moph.go.th/index.php/s/wbioWZAQfManokc
Thailand,2020-09-26,1066486,4101,1066486,4101,http://nextcloud.dmsc.moph.go.th/index.php/s/wbioWZAQfManokc
Thailand,2020-09-27,1070253,3767,1070253,3767,http://nextcloud.dmsc.moph.go.th/index.php/s/wbioWZAQfManokc
Thailand,2020-09-28,1075148,4895,1075148,4895,http://nextcloud.dmsc.moph.go.th/index.php/s/wbioWZAQfManokc
Thailand,2020-09-29,1080512,5364,1080512,5364,http://nextcloud.dmsc.moph.go.th/index.php/s/wbioWZAQfManokc
Thailand,2020-09-30,1085502,4990,1085502,4990,http://nextcloud.dmsc.moph.go.th/index.php/s/wbioWZAQfManokc
Thailand,2020-10-01,1089844,4342,1089844,4342,http://nextcloud.dmsc.moph.go.th/index.php/s/wbioWZAQfManokc
Thailand,2020-10-02,1093941,4097,1093941,4097,http://nextcloud.dmsc.moph.go.th/index.php/s/wbioWZAQfManokc
Thailand,2020-10-03,1097277,3336,1097277,3336,http://nextcloud.dmsc.moph.go.th/index.php/s/wbioWZAQfManokc
Thailand,2020-10-04,1101227,3950,1101227,3950,http://nextcloud.dmsc.moph.go.th/index.php/s/wbioWZAQfManokc
Thailand,2020-10-05,1105382,4155,1105382,4155,http://nextcloud.dmsc.moph.go.th/index.php/s/wbioWZAQfManokc
Thailand,2020-10-06,1109258,3876,1109258,3876,http://nextcloud.dmsc.moph.go.th/index.php/s/wbioWZAQfManokc
Thailand,2020-10-07,1113533,4275,1113533,4275,http://nextcloud.dmsc.moph.go.th/index.php/s/wbioWZAQfManokc
Thailand,2020-10-08,1118121,4588,1118121,4588,http://nextcloud.dmsc.moph.go.th/index.php/s/wbioWZAQfManokc
Thailand,2020-10-09,1124002,5881,1124002,5881,http://nextcloud.dmsc.moph.go.th/index.php/s/wbioWZAQfManokc
Thailand,2020-10-10,1128598,4596,1128598,4596,http://nextcloud.dmsc.moph.go.th/index.php/s/wbioWZAQfManokc
Thailand,2020-10-11,1131961,3363,1131961,3363,http://nextcloud.dmsc.moph.go.th/index.php/s/wbioWZAQfManokc
Thailand,2020-10-12,1137019,5058,1137019,5058,http://nextcloud.dmsc.moph.go.th/index.php/s/wbioWZAQfManokc
Thailand,2020-10-13,1141589,4570,1141589,4570,http://nextcloud.dmsc.moph.go.th/index.php/s/wbioWZAQfManokc
Thailand,2020-10-14,1146582,4993,1146582,4993,http://nextcloud.dmsc.moph.go.th/index.php/s/wbioWZAQfManokc
Thailand,2020-10-15,1151354,4772,1151354,4772,http://nextcloud.dmsc.moph.go.th/index.php/s/wbioWZAQfManokc
Thailand,2020-10-16,1156392,5038,1156392,5038,http://nextcloud.dmsc.moph.go.th/index.php/s/wbioWZAQfManokc
Thailand,2020-10-17,1159972,3580,1159972,3580,http://nextcloud.dmsc.moph.go.th/index.php/s/wbioWZAQfManokc
Thailand,2020-10-18,1163881,3909,1163881,3909,http://nextcloud.dmsc.moph.go.th/index.php/s/wbioWZAQfManokc
Thailand,2020-10-19,1168855,4974,1168855,4974,http://nextcloud.dmsc.moph.go.th/index.php/s/wbioWZAQfManokc
Thailand,2020-10-20,1175692,6837,1175692,6837,http://nextcloud.dmsc.moph.go.th/index.php/s/wbioWZAQfManokc
Thailand,2020-10-21,1180730,5038,1180730,5038,http://nextcloud.dmsc.moph.go.th/index.php/s/wbioWZAQfManokc
Thailand,2020-10-22,1185685,4955,1185685,4955,http://nextcloud.dmsc.moph.go.th/index.php/s/wbioWZAQfManokc
Thailand,2020-10-23,1189965,4280,1189965,4280,http://nextcloud.dmsc.moph.go.th/index.php/s/wbioWZAQfManokc
Thailand,2020-10-24,1194015,4050,1194015,4050,http://nextcloud.dmsc.moph.go.th/index.php/s/wbioWZAQfManokc
Thailand,2020-10-25,1197186,3171,1197186,3171,http://nextcloud.dmsc.moph.go.th/index.php/s/wbioWZAQfManokc
Thailand,2020-10-26,1202089,4903,1202089,4903,http://nextcloud.dmsc.moph.go.th/index.php/s/wbioWZAQfManokc
Thailand,2020-10-27,1207222,5133,1207222,5133,http://nextcloud.dmsc.moph.go.th/index.php/s/wbioWZAQfManokc
Thailand,2020-10-28,1211472,4250,1211472,4250,http://nextcloud.dmsc.moph.go.th/index.php/s/wbioWZAQfManokc
Thailand,2020-10-29,1216015,4543,1216015,4543,http://nextcloud.dmsc.moph.go.th/index.php/s/wbioWZAQfManokc
Thailand,2020-10-30,1219920,3905,1219920,3905,http://nextcloud.dmsc.moph.go.th/index.php/s/wbioWZAQfManokc
Thailand,2020-10-31,1223437,3517,1223437,3517,http://nextcloud.dmsc.moph.go.th/index.php/s/wbioWZAQfManokc
Thailand,2020-11-01,1226422,2985,1226422,2985,http://nextcloud.dmsc.moph.go.th/index.php/s/wbioWZAQfManokc
Thailand,2020-11-02,1230570,4148,1230570,4148,http://nextcloud.dmsc.moph.go.th/index.php/s/wbioWZAQfManokc
Thailand,2020-11-03,1235804,5234,1235804,5234,http://nextcloud.dmsc.moph.go.th/index.php/s/wbioWZAQfManokc
Thailand,2020-11-04,1240353,4549,1240353,4549,http://nextcloud.dmsc.moph.go.th/index.php/s/wbioWZAQfManokc
Thailand,2020-11-05,1244694,4341,1244694,4341,http://nextcloud.dmsc.moph.go.th/index.php/s/wbioWZAQfManokc
Thailand,2020-11-06,1247870,3176,1247870,3176,http://nextcloud.dmsc.moph.go.th/index.php/s/wbioWZAQfManokc
Thailand,2020-11-07,1251708,3838,1251708,3838,http://nextcloud.dmsc.moph.go.th/index.php/s/wbioWZAQfManokc
Thailand,2020-11-08,1254523,2815,1254523,2815,http://nextcloud.dmsc.moph.go.th/index.php/s/wbioWZAQfManokc
Thailand,2020-11-09,1258106,3583,1258106,3583,http://nextcloud.dmsc.moph.go.th/index.php/s/wbioWZAQfManokc
Thailand,2020-11-10,1262770,4664,1262770,4664,http://nextcloud.dmsc.moph.go.th/index.php/s/wbioWZAQfManokc
Thailand,2020-11-11,1267439,4669,1267439,4669,http://nextcloud.dmsc.moph.go.th/index.php/s/wbioWZAQfManokc
Thailand,2020-11-12,1271524,4085,1271524,4085,http://nextcloud.dmsc.moph.go.th/index.php/s/wbioWZAQfManokc
Thailand,2020-11-13,1274989,3465,1274989,3465,http://nextcloud.dmsc.moph.go.th/index.php/s/wbioWZAQfManokc
Thailand,2020-11-14,1278442,3453,1278442,3453,http://nextcloud.dmsc.moph.go.th/index.php/s/wbioWZAQfManokc
Thailand,2020-11-15,1280986,2544,1280986,2544,http://nextcloud.dmsc.moph.go.th/index.php/s/wbioWZAQfManokc
Thailand,2020-11-16,1284039,3053,1284039,3053,http://nextcloud.dmsc.moph.go.th/index.php/s/wbioWZAQfManokc
Thailand,2020-11-17,1288263,4224,1288263,4224,http://nextcloud.dmsc.moph.go.th/index.php/s/wbioWZAQfManokc
Thailand,2020-11-18,1292743,4480,1292743,4480,http://nextcloud.dmsc.moph.go.th/index.php/s/wbioWZAQfManokc
Thailand,2020-11-19,1295334,2591,1295334,2591,http://nextcloud.dmsc.moph.go.th/index.php/s/wbioWZAQfManokc
Thailand,2020-11-20,1297947,2613,1297947,2613,http://nextcloud.dmsc.moph.go.th/index.php/s/wbioWZAQfManokc
Thailand,2020-11-21,1300361,2414,1300361,2414,http://nextcloud.dmsc.moph.go.th/index.php/s/wbioWZAQfManokc
Thailand,2020-11-22,1302799,2438,1302799,2438,http://nextcloud.dmsc.moph.go.th/index.php/s/wbioWZAQfManokc
Thailand,2020-11-23,1306478,3679,1306478,3679,http://nextcloud.dmsc.moph.go.th/index.php/s/wbioWZAQfManokc
Thailand,2020-11-24,1310593,4115,1310593,4115,http://nextcloud.dmsc.moph.go.th/index.php/s/wbioWZAQfManokc
Thailand,2020-11-25,1315026,4433,1315026,4433,http://nextcloud.dmsc.moph.go.th/index.php/s/wbioWZAQfManokc
Thailand,2020-11-26,1318460,3434,1318460,3434,http://nextcloud.dmsc.moph.go.th/index.php/s/wbioWZAQfManokc
Thailand,2020-11-27,1322571,4111,1322571,4111,http://nextcloud.dmsc.moph.go.th/index.php/s/wbioWZAQfManokc
Thailand,2020-11-28,1325786,3215,1325786,3215,http://nextcloud.dmsc.moph.go.th/index.php/s/wbioWZAQfManokc
Thailand,2020-11-29,1329148,3362,1329148,3362,http://nextcloud.dmsc.moph.go.th/index.php/s/wbioWZAQfManokc
Thailand,2020-11-30,1333653,4505,1333653,4505,http://nextcloud.dmsc.moph.go.th/index.php/s/wbioWZAQfManokc
Thailand,2020-12-01,1338895,5242,1338895,5242,http://nextcloud.dmsc.moph.go.th/index.php/s/wbioWZAQfManokc
Thailand,2020-12-02,1344195,5300,1344195,5300,http://nextcloud.dmsc.moph.go.th/index.php/s/wbioWZAQfManokc
Thailand,2020-12-03,1349548,5353,1349548,5353,http://nextcloud.dmsc.moph.go.th/index.php/s/wbioWZAQfManokc
Thailand,2020-12-04,1355331,5783,1355331,5783,http://nextcloud.dmsc.moph.go.th/index.php/s/wbioWZAQfManokc
Thailand,2020-12-05,1360631,5300,1360631,5300,http://nextcloud.dmsc.moph.go.th/index.php/s/wbioWZAQfManokc
Thailand,2020-12-06,1365215,4584,1365215,4584,http://nextcloud.dmsc.moph.go.th/index.php/s/wbioWZAQfManokc
Thailand,2020-12-07,1370912,5697,1370912,5697,http://nextcloud.dmsc.moph.go.th/index.php/s/wbioWZAQfManokc
Thailand,2020-12-08,1378209,7297,1378209,7297,http://nextcloud.dmsc.moph.go.th/index.php/s/wbioWZAQfManokc
Thailand,2020-12-09,1385887,7678,1385887,7678,http://nextcloud.dmsc.moph.go.th/index.php/s/wbioWZAQfManokc
Thailand,2020-12-10,1391652,5765,1391652,5765,http://nextcloud.dmsc.moph.go.th/index.php/s/wbioWZAQfManokc
Thailand,2020-12-11,1396312,4660,1396312,4660,http://nextcloud.dmsc.moph.go.th/index.php/s/wbioWZAQfManokc
Thailand,2020-12-12,1400356,4044,1400356,4044,http://nextcloud.dmsc.moph.go.th/index.php/s/wbioWZAQfManokc
Thailand,2020-12-13,1404094,3738,1404094,3738,http://nextcloud.dmsc.moph.go.th/index.php/s/wbioWZAQfManokc
Thailand,2020-12-14,1409173,5079,1409173,5079,http://nextcloud.dmsc.moph.go.th/index.php/s/wbioWZAQfManokc
Thailand,2020-12-15,1415347,6174,1415347,6174,http://nextcloud.dmsc.moph.go.th/index.php/s/wbioWZAQfManokc
Thailand,2020-12-16,1422127,6780,1422127,6780,http://nextcloud.dmsc.moph.go.th/index.php/s/wbioWZAQfManokc
Thailand,2020-12-17,1427512,5385,1427512,5385,http://nextcloud.dmsc.moph.go.th/index.php/s/wbioWZAQfManokc
Thailand,2020-12-18,1432852,5340,1432852,5340,http://nextcloud.dmsc.moph.go.th/index.php/s/wbioWZAQfManokc
Thailand,2020-12-19,1438169,5317,1438169,5317,http://nextcloud.dmsc.moph.go.th/index.php/s/wbioWZAQfManokc
Thailand,2020-12-20,1445679,7510,1445679,7510,http://nextcloud.dmsc.moph.go.th/index.php/s/wbioWZAQfManokc
Thailand,2020-12-21,1463412,17733,1463412,17733,http://nextcloud.dmsc.moph.go.th/index.php/s/wbioWZAQfManokc
Thailand,2020-12-22,1483549,20137,1483549,20137,http://nextcloud.dmsc.moph.go.th/index.php/s/wbioWZAQfManokc
Thailand,2020-12-23,1508754,25205,1508754,25205,http://nextcloud.dmsc.moph.go.th/index.php/s/wbioWZAQfManokc
Thailand,2020-12-24,1534073,25319,1534073,25319,http://nextcloud.dmsc.moph.go.th/index.php/s/wbioWZAQfManokc
Thailand,2020-12-25,1555405,21332,1555405,21332,http://nextcloud.dmsc.moph.go.th/index.php/s/wbioWZAQfManokc
Thailand,2020-12-26,1574288,18883,1574288,18883,http://nextcloud.dmsc.moph.go.th/index.php/s/wbioWZAQfManokc
Thailand,2020-12-27,1587747,13459,1587747,13459,http://nextcloud.dmsc.moph.go.th/index.php/s/wbioWZAQfManokc
Thailand,2020-12-28,1608831,21084,1608831,21084,http://nextcloud.dmsc.moph.go.th/index.php/s/wbioWZAQfManokc
Thailand,2020-12-29,1629195,20364,1629195,20364,http://nextcloud.dmsc.moph.go.th/index.php/s/wbioWZAQfManokc
Thailand,2020-12-30,1652565,23370,1652565,23370,http://nextcloud.dmsc.moph.go.th/index.php/s/wbioWZAQfManokc
Thailand,2020-12-31,1666299,13734,1666299,13734,http://nextcloud.dmsc.moph.go.th/index.php/s/wbioWZAQfManokc
Thailand,2021-01-01,1675868,9569,1675868,9569,http://nextcloud.dmsc.moph.go.th/index.php/s/wbioWZAQfManokc
Thailand,2021-01-02,1687135,11267,1687135,11267,http://nextcloud.dmsc.moph.go.th/index.php/s/wbioWZAQfManokc
Thailand,2021-01-03,1701327,14192,1701327,14192,http://nextcloud.dmsc.moph.go.th/index.php/s/wbioWZAQfManokc
Thailand,2021-01-04,1724674,23347,1724674,23347,http://nextcloud.dmsc.moph.go.th/index.php/s/wbioWZAQfManokc
Thailand,2021-01-05,1756099,31425,1756099,31425,http://nextcloud.dmsc.moph.go.th/index.php/s/wbioWZAQfManokc
Thailand,2021-01-06,1789909,33810,1789909,33810,http://nextcloud.dmsc.moph.go.th/index.php/s/wbioWZAQfManokc
Thailand,2021-01-07,1822550,32641,1822550,32641,http://nextcloud.dmsc.moph.go.th/index.php/s/wbioWZAQfManokc
Thailand,2021-01-08,1857854,35304,1857854,35304,http://nextcloud.dmsc.moph.go.th/index.php/s/wbioWZAQfManokc
Thailand,2021-01-09,1885770,27916,1885770,27916,http://nextcloud.dmsc.moph.go.th/index.php/s/wbioWZAQfManokc
Thailand,2021-01-10,1903599,17829,1903599,17829,http://nextcloud.dmsc.moph.go.th/index.php/s/wbioWZAQfManokc
Thailand,2021-01-11,1939697,36098,1939697,36098,http://nextcloud.dmsc.moph.go.th/index.php/s/wbioWZAQfManokc
Thailand,2021-01-12,1968925,29228,1968925,29228,http://nextcloud.dmsc.moph.go.th/index.php/s/wbioWZAQfManokc
Thailand,2021-01-13,1996674,27749,1996674,27749,http://nextcloud.dmsc.moph.go.th/index.php/s/wbioWZAQfManokc
Thailand,2021-01-14,2028289,31615,2028289,31615,http://nextcloud.dmsc.moph.go.th/index.php/s/wbioWZAQfManokc
Thailand,2021-01-15,2057604,29315,2057604,29315,http://nextcloud.dmsc.moph.go.th/index.php/s/wbioWZAQfManokc
Thailand,2021-01-16,2078780,21176,2078780,21176,http://nextcloud.dmsc.moph.go.th/index.php/s/wbioWZAQfManokc
Thailand,2021-01-17,2092671,13891,2092671,13891,http://nextcloud.dmsc.moph.go.th/index.php/s/wbioWZAQfManokc
Thailand,2021-01-18,2112408,19737,2112408,19737,http://nextcloud.dmsc.moph.go.th/index.php/s/wbioWZAQfManokc
Thailand,2021-01-19,2140878,28470,2140878,28470,http://nextcloud.dmsc.moph.go.th/index.php/s/wbioWZAQfManokc
Thailand,2021-01-20,2165829,24951,2165829,24951,http://nextcloud.dmsc.moph.go.th/index.php/s/wbioWZAQfManokc
Thailand,2021-01-21,2190766,24937,2190766,24937,http://nextcloud.dmsc.moph.go.th/index.php/s/wbioWZAQfManokc
Thailand,2021-01-22,2217894,27128,2217894,27128,http://nextcloud.dmsc.moph.go.th/index.php/s/wbioWZAQfManokc
Thailand,2021-01-23,2236065,18171,2236065,18171,http://nextcloud.dmsc.moph.go.th/index.php/s/wbioWZAQfManokc
Thailand,2021-01-24,2246247,10182,2246247,10182,http://nextcloud.dmsc.moph.go.th/index.php/s/wbioWZAQfManokc
Thailand,2021-01-25,2263709,17462,2263709,17462,http://nextcloud.dmsc.moph.go.th/index.php/s/wbioWZAQfManokc
Thailand,2021-01-26,2287806,24097,2287806,24097,http://nextcloud.dmsc.moph.go.th/index.php/s/wbioWZAQfManokc
Thailand,2021-01-27,2313021,25215,2313021,25215,http://nextcloud.dmsc.moph.go.th/index.php/s/wbioWZAQfManokc
Thailand,2021-01-28,2335860,22839,2335860,22839,http://nextcloud.dmsc.moph.go.th/index.php/s/wbioWZAQfManokc
Thailand,2021-01-29,2355972,20112,2355972,20112,http://nextcloud.dmsc.moph.go.th/index.php/s/wbioWZAQfManokc
Thailand,2021-01-30,2377606,21634,2377606,21634,http://nextcloud.dmsc.moph.go.th/index.php/s/wbioWZAQfManokc
Thailand,2021-01-31,2392344,14738,2392344,14738,http://nextcloud.dmsc.moph.go.th/index.php/s/wbioWZAQfManokc
Thailand,2021-02-01,2409704,17360,2409704,17360,http://nextcloud.dmsc.moph.go.th/index.php/s/wbioWZAQfManokc
Thailand,2021-02-02,2430307,20603,2430307,20603,http://nextcloud.dmsc.moph.go.th/index.php/s/wbioWZAQfManokc
Thailand,2021-02-03,2451533,21226,2451533,21226,http://nextcloud.dmsc.moph.go.th/index.php/s/wbioWZAQfManokc
Thailand,2021-02-04,2472793,21260,2472793,21260,http://nextcloud.dmsc.moph.go.th/index.php/s/wbioWZAQfManokc
Thailand,2021-02-05,2491520,18727,2491520,18727,http://nextcloud.dmsc.moph.go.th/index.php/s/wbioWZAQfManokc
Thailand,2021-02-06,2508245,16725,2508245,16725,http://nextcloud.dmsc.moph.go.th/index.php/s/wbioWZAQfManokc
Thailand,2021-02-07,2518067,9822,2518067,9822,http://nextcloud.dmsc.moph.go.th/index.php/s/wbioWZAQfManokc
Thailand,2021-02-08,2531211,13144,2531211,13144,http://nextcloud.dmsc.moph.go.th/index.php/s/wbioWZAQfManokc
Thailand,2021-02-09,2547729,16518,2547729,16518,http://nextcloud.dmsc.moph.go.th/index.php/s/wbioWZAQfManokc
Thailand,2021-02-10,2565264,17535,2565264,17535,http://nextcloud.dmsc.moph.go.th/index.php/s/wbioWZAQfManokc
Thailand,2021-02-11,2582544,17280,2582544,17280,http://nextcloud.dmsc.moph.go.th/index.php/s/wbioWZAQfManokc
Thailand,2021-02-12,2596045,13501,2596045,13501,http://nextcloud.dmsc.moph.go.th/index.php/s/wbioWZAQfManokc
Thailand,2021-02-13,2603344,7299,2603344,7299,http://nextcloud.dmsc.moph.go.th/index.php/s/wbioWZAQfManokc
Thailand,2021-02-14,2610585,7241,2610585,7241,http://nextcloud.dmsc.moph.go.th/index.php/s/wbioWZAQfManokc
Thailand,2021-02-15,2623264,12679,2623264,12679,http://nextcloud.dmsc.moph.go.th/index.php/s/wbioWZAQfManokc
Thailand,2021-02-16,2639933,16669,2639933,16669,http://nextcloud.dmsc.moph.go.th/index.php/s/wbioWZAQfManokc
Thailand,2021-02-17,2656356,16423,2656356,16423,http://nextcloud.dmsc.moph.go.th/index.php/s/wbioWZAQfManokc
Thailand,2021-02-18,2673477,17121,2673477,17121,http://nextcloud.dmsc.moph.go.th/index.php/s/wbioWZAQfManokc
Thailand,2021-02-19,2692397,18920,2692397,18920,http://nextcloud.dmsc.moph.go.th/index.php/s/wbioWZAQfManokc
Thailand,2021-02-20,2702674,10277,2702674,10277,http://nextcloud.dmsc.moph.go.th/index.php/s/wbioWZAQfManokc
Thailand,2021-02-21,2713696,11022,2713696,11022,http://nextcloud.dmsc.moph.go.th/index.php/s/wbioWZAQfManokc
Thailand,2021-02-22,2713696,0,2713696,0,http://nextcloud.dmsc.moph.go.th/index.php/s/wbioWZAQfManokc
Thailand,2021-02-23,2713696,0,2713696,0,http://nextcloud.dmsc.moph.go.th/index.php/s/wbioWZAQfManokc
Thailand,2021-02-24,2713696,0,2713696,0,http://nextcloud.dmsc.moph.go.th/index.php/s/wbioWZAQfManokc
Thailand,2021-02-25,2713696,0,2713696,0,http://nextcloud.dmsc.moph.go.th/index.php/s/wbioWZAQfManokc
Thailand,2021-02-26,2713696,0,2713696,0,http://nextcloud.dmsc.moph.go.th/index.php/s/wbioWZAQfManokc
Thailand,2021-02-27,2713696,0,2713696,0,http://nextcloud.dmsc.moph.go.th/index.php/s/wbioWZAQfManokc
Thailand,2021-02-28,2713696,0,2713696,0,http://nextcloud.dmsc.moph.go.th/index.php/s/wbioWZAQfManokc
Thailand,2021-03-01,2713696,0,2713696,0,http://nextcloud.dmsc.moph.go.th/index.php/s/wbioWZAQfManokc
